с: со Со 
есть: Есть есть 
определять: определяет определять 
описывать: описываете описывает описывать Описываемое 
подписываться: подписывайтесь подписывается 
простейшее: простейшим простейшие 
восстановить: восстановить восстановят 
почта: Почта почта почту 
технический: техническая Техническое технические технической технический Технический технических Техническая техническое 
доступ: доступа Доступ доступе доступ доступом 
ответ: ответами ответа ответах ответы ответ ответов 
свободный: свободного свободные свободный 
рандомное: рандомное 
рабочий: рабочих рабочие рабочего рабочей рабочее рабочая рабочий 
договориться: договориться 
создавать: создаю создавая создаем создает создаваемых создавали создающие создавать Создаем создают создаваемым 
дешёвый: дешевый дешевле 
значительный: значительной значительных значительное значительные 
джуда: Джуда 
символ: символов символы символ символом 
три: трех тремя Три три 
нужно: нужно Нужно 
волновать: волнует волновало 
подобный: Подобная подобные подобный Подобное 
вывинчивание: вывинчиванием 
наличие: наличии наличие 
структура: структуре структуры структурой 
занимать: занимаемой занимаемого занимало занимает 
диаграмма: диаграмма 
они: ими Им них Их ними ним Они они их им 
россия: России Россия Россию 
выполнить: выполните выполненной выполнен выполненный выполненные 
стенд: стенда стенде стенд стендов 
тысяча: тысяч 
выяснить: выяснить выяснил выяснили 
обработать: обработанные обработанных 
добавить: добавленного добавленный добавить добавим Добавил добавленное добавлена добавьте Добавим Добавить Добавьте добавили 
определяться: определяется определяться определяются 
светоотражающий: светоотражающая 
формирование: формирование формирования 
общественный: общественного 
бизнес: бизнесов бизнеса бизнесом Бизнес бизнес 
бюджет: бюджетами 
трудность: трудности Трудности 
хороший: хороших хороший хорошую наилучшую хороша лучших лучше лучшие лучший хорошей Лучшие хорошая лучшего Лучший 
любой: любого Любое любой любому любые любых 
наглядный: наглядным наглядном 
опьянить: опьянен 
коллега: коллег 
диагностика: диагностики диагностикой 
корпоративный: Корпоративный корпоративного корпоративной корпоративные корпоративных 
самойленко: Самойленко 
отдельный: отдельную отдельные отдельный отдельных 
продемонстрировать: продемонстрировать 
если: если Если 
покупатель: Покупатель покупателями покупателей покупатель 
увеличить: увеличить 
тахометр: тахометром 
альтернативный: альтернативных Альтернативные 
бэм: БЭМ 
архитектурный: архитектурная 
изменять: изменяет изменять изменяющему 
полноправный: полноправные 
содействовать: содействовать 
вторичный: вторичное Вторичный вторичного вторичные вторичный вторичным вторичных 
относить: относят относит 
снизить: снизить 
промежуточный: промежуточные промежуточное 
настройка: настройкой настроек Настройка Настройки настройки настройка настройке 
называть: называемой называемые называют 
февраль: феврале февраля 
конфигурация: конфигурациями конфигурацию конфигурации Конфигурация конфигурация конфигураций 
закон: закона законом закон 
перечисляться: перечисляются 
возникать: возникающую возникает возникающие возникающий возникали возникающая Возникает возникающему возникать возникают возникающих 
ложиться: ложится 
бакетов: Бакетов бакетов 
многое: многого многое многом 
заголовок: заголовок Заголовок заголовков заголовка заголовки 
оно: Оно оно 
проблема: проблеме проблему проблема проблемами Проблемы проблемам проблем проблемы 
екатерина: Екатерина 
удар: удары удар 
нлмк: НЛМК 
электромобиль: электромобиля 
думать: думаете Думаю думает думаю 
действовать: действующая действуют действующими действующих действующие действовать действует действующей 
собственно: Собственно 
привет: Привет привет 
строить: строят строить 
понять: понять понявших понял Понять 
закрепить: закрепленном закреплены закрепленные закреплен 
алгоритмав: алгоритмаВ 
нельзя: нельзя 
отправлять: отправляет отправляем 
рейтят: рейтят 
факт: факты факту факт 
безопасный: безопасный безопасного 
назначение: назначение назначению назначения 
инфраструктура: инфраструктуру инфраструктуры инфраструктурой инфраструктура инфраструктуре 
изменение: изменений изменение изменения изменениями Изменение изменениям изменении 
весь: всех всем всего всему вся всеми всей всю Всем Всех Всего 
гитхаб: гитхаб 
обойтись: обойтись обойдемся 
центровка: центровку 
интерфейс: интерфейс интерфейсов интерфейсы интерфейсами интерфейсу интерфейса 
типыво: типыВо 
человек: человека людям люди Люди людей Человек людьми человек 
нужный: нужен нужные нужный нужным Нужны нужна нужного нужны нужную 
библиотека: библиотека библиотек библиотекой библиотеку библиотеки 
позволять: позволять позволяющая позволяя позволяющую позволяющий позволяющие позволяет позволяют 
кластеризациипревратится: кластеризациипревратится 
коммерческий: коммерческих коммерческого коммерческой 
работать: работают работает работающих Работать работавшая Работает работали работать работающее работающие работало 
кластеревыбор: кластереВыбор 
следственный: следственной следственная следственным следственных следственные следственными следственное 
внешний: внешних внешние Внешний внешней внешний 
такой: такая такие такую такими Такие такое таком таким Таким такой таких такого 
ноутбукв: ноутбукВ 
на: На на 
иллюстрировать: иллюстрирует 
ты: тебя тебе ты Ты 
умный: умной 
желаемый: желаемого желаемых 
совершение: совершении 
прочтение: прочтение 
видеокарта: видеокарта видеокарты видеокартой 
заметить: заметить Заметим 
размещать: размещать 
точка: точек точку точкой точки точка точках 
потоковый: Потоковая потоковую потоковых потоковые потоковой 
рассмотреть: рассмотрим рассмотреть Рассмотрим рассмотрен 
ак: АК 
собственный: собственную собственными собственный собственной собственные собственном собственных 
план: планах план плане 
отказоустойчивость: отказоустойчивости Отказоустойчивость 
последующий: последующим последующие последующее 
тренировка: тренировки Тренировка 
режим: режим режиме режимах режимы 
браузер: браузеров браузер 
определённый: определенным определенный определенном определенного определенной определенными определенная 
вернуться: Вернуться вернуться вернувшегося 
предоставить: предоставили предоставить 
принимать: принимает принимать 
список: списком списка Список списки списке список 
ископаемое: ископаемых 
втб: ВТБ 
несбалансированный: несбалансированные 
сетевой: сетевой сетевые Сетевые сетевых сетевого сетевым 
объём: объема Объем объемом объем объему объемами 
черта: чертами 
инженер: инженер Инженер инженеров инженерами Инженеры инженеры инженерам 
гб: ГБ 
пожалуйста: пожалуйста Пожалуйста 
функция: функция функций функцию функции Функция 
предварительно: предварительно 
замотать: замотают 
материал: материалы материала материале материалов 
создание: Создание созданию создание создания создании 
указать: указаны указать Укажите указанным 
датчик: датчиков датчики датчик датчика Датчики 
получать: получая получает получать получают получаем Получаем 
вызываться: вызывается 
присутствовать: присутствует присутствовать 
серверный: серверного 
интересный: интересную интересных интересным Интересные интересны интересного интересная интересное интересна интересный интересен 
делать: делать делаете делаем делал делают делает Делаем 
практика: практики практик практике практика 
подвижность: подвижность подвижностью 
мультисерверной: мультисерверной 
актуальный: актуальных актуален актуальными актуальные актуальным актуальный актуальное актуальной 
коллекция: коллекциях 
нейтральный: нейтральным нейтральное 
миграция: миграции 
штука: штук 
трудный: трудных 
поступательный: поступательного 
крепление: крепления 
производство: производства Производство 
производственный: производственных производственной 
реагировать: реагируют реагировать реагирует 
цифровой: Цифровой цифровых цифровая цифровые Цифровые цифрового цифровой Цифровое 
ускоренный: ускоренному ускоренный ускоренного 
смартфон: смартфоны Смартфоны 
ведущий: ведущий ведущих Ведущая 
результат: результатов результатам Результат результате результатом результатах результата результат Результаты результаты 
местоположение: местоположении 
важно: важно Важно 
отделять: отделяют отделять 
вибрация: вибрации Вибрация вибрацию вибрация вибрациях 
расцентровки: расцентровки 
делегирование: делегирование 
коршун: Коршун 
широкий: широкое широким широкому широком 
огромный: огромными огромные огромном огромной огромного огромных 
фундамент: фундамента фундаменте 
стандартный: стандартную стандартные стандартными Стандартным 
закрепляться: закрепляется 
платформа: платформе платформой платформы платформ платформах платформа платформу 
математик: Математик Математика математика математиков 
октябрь: октябре октября 
удобство: Удобство удобства удобству 
очередь: очереди очередь 
одновременно: одновременно 
измерение: Измерения измерениях измерениям измерения 
проект: проектам проектах проекте проектов проектами проекта проектом проект проекты проекту 
пояснение: пояснениях 
разбор: разбора 
ось: ось осью оси 
политика: политики политику политика 
синтетический: синтетическим синтетических 
истинный: истинных истинное 
перевод: перевод Перевод переводов 
возможность: возможностях возможность возможностям Возможность возможностью возможностями Возможности возможностей возможности 
выходить: выходят выходит 
власенко: Власенко 
поток: потоками Поток Потоки потоки потоков потока поток 
комфортно: комфортно 
аппарат: аппараты 
подшипник: подшипники подшипников подшипник подшипниках 
заметный: заметной 
каскадный: каскадный 
реализовывать: реализовывать 
создать: Создайте созданные Создал созданная создана создайте создаст создать Создать создали созданный создан создадут созданному 
джуде: Джуде 
диагностический: диагностический диагностическом 
робот: роботы Роботы роботов робота робот 
второй: вторая Вторым Второй второго вторых второй 
централизовать: централизованном Централизованное централизованным централизованного Централизованного централизованное 
промышленный: промышленного Промышленная промышленные Промышленные промышленных 
сайт: сайтов сайтам сайт Сайт сайта сайты сайте 
отношение: отношению отношениях отношении отношений 
проникновение: проникновения проникновение 
упрощать: упрощающий упрощает 
ошибаться: ошибался ошибается 
патент: патенты патента патенту Патент патентов патенте патент 
группа: группой группами Группа группа группы групп 
связать: связаны связанная свяжет связать связано связан 
специалист: Специалист специалистов специалиста специалистами специалист специалистам 
отдел: отдел отдела отделов 
ожидать: ожидаем ожидает ожидали ожидать 
телефон: телефонов телефону 
отвечать: отвечая отвечает 
прописать: прописать 
жаловаться: жаловались жаловаться 
тихий: тихому 
плюсиков: плюсиков 
аналитик: аналитик аналитике аналитику Аналитик аналитики аналитиков аналитиком 
информационный: Информационные Информационная информационная информационной информационную информационные 
конфигуратор: конфигуратору Конфигуратор конфигуратором конфигуратор 
преобразовать: преобразует 
печатный: печатных 
подключение: подключением подключения подключений Подключение подключение 
неопределённо: неопределенно 
русскоязычный: русскоязычное 
жёсткий: жесткими жестких жесткий жесткой жесткого Жесткий Жесткие жесткие жестким 
фреймворк: фреймворка фреймворке фреймворками фреймворков фреймворком фреймворк Фреймворк 
язык: языке Язык языках Языка языком языками языка языков языки язык 
двоичный: двоичное 
круг: кругов круг 
стать: станет стало Станет стать стали стал статей Стало 
который: которых которой которым которому которого который которыми которую котором которые которое которая 
диск: диски диске 
искусственный: искусственным Искусственный искусственный искусственном искусственного искусственному 
генерация: генерация генерации генерацию 
сгенерировать: сгенерировано 
рфрит: РФРИТ 
белый: Белый 
соответствовать: соответствующий соответствует соответствующем соответствующее соответствующей 
формат: формата форматы формате форматов формат 
приобретение: приобретение приобретения 
затравка: затравки затравку затравках затравке затравок затравками 
содержать: содержащего содержат содержать содержит содержащее 
серьёзно: серьезно 
гармонический: гармоническое гармонический 
компиляция: компиляция компиляции 
разработка: разработке разработка разработки разработку разработок разработкам Разработка разработкой 
вызвать: вызовет вызванной вызвали вызванная вызван вызванные 
стиль: стиля стили стиль стилям стилей Стили 
выявлять: выявляет выявлять 
тренд: тренды Тренды трендов трендам 
блок: блоков блок блока блоки 
ценный: ценно ценному 
смещаться: смещаться 
преодолеть: преодолел 
компонент: компонента компонентам компонентах компоненте компонентов компонентом компонент компоненты Компоненты 
краткий: Краткий краткое 
предприятие: Предприятия предприятиям предприятия 
остаточный: остаточного остаточный остаточной 
облачный: Облачные Облачная облачные облачным облачная облачной облачный 
комфорт: комфорта 
строй: строя 
современность: современности 
техноавтор: Техноавтор 
коммита: коммита 
конвейер: конвейер конвейера конвейеров 
контекстный: Контекстное контекстное 
подсчитать: подсчитать 
кнопка: кнопка кнопки кнопке кнопкой Кнопка кнопку 
потребность: потребностей потребностям потребность потребности 
вниз: вниз 
блансировочные: блансировочные 
вопрос: вопросов вопросам Вопрос вопросы вопрос Вопросы вопросами вопросе вопросом вопроса 
аэродинамический: Аэродинамические аэродинамическая аэродинамический 
рассчитываться: рассчитываются 
сми: СМИ 
нескомпенсированный: нескомпенсированные нескомпенсированная нескомпенсированную 
цена: цену цены цена Цена 
войти: вошедших Войдите войти вошел 
компьютерный: компьютерного компьютерных компьютерной Компьютерное 
нейронный: нейронных нейронная нейронной 
мнение: мнению мнение 
лишний: лишним 
поле: поля поле 
индекс: индексов индексы индексу Индексы индекс 
непонятно: непонятно 
лёгкий: легче легок 
генерировать: генерировать генерируя генерирующей генерирует генерируемыми 
электромагнит: электромагнит 
оказываться: оказываемся оказывается Оказывается 
осваивать: осваивают 
банк: банка Банка банки банк Банк банков банком 
обесценить: обесценить 
уравновешиваться: уравновешивается 
комментарий: комментария комментарии Комментарий Комментарии комментариях комментарий 
видеть: видим видя видеть вижу видит 
принятие: принятия принятии 
дообученная: Дообученная дообученная 
видно: видно 
пометить: помеченные 
причина: причины причинами причин причинах причине 
отнести: отнести 
учётный: учетной учетных учетные 
манипуляция: манипуляций 
сродни: сродни 
довольный: доволен 
ускорять: ускоряет 
он: него Он Его ему он его Ему 
мышление: мышления мышление 
вносить: вносить 
недавно: недавно 
гибкий: гибкий гибких гибкие гибкой гибкого 
участвовать: участвовать Участвуем участвует 
отклик: отклика 
увидеть: увидеть увидите 
задать: заданным задать заданный заданными 
заменить: заменить 
способ: Способ способом способы способов способами способ способа Способы 
зря: зря Зря 
алгоритм: алгоритма алгоритмом алгоритмах алгоритмами алгоритмы алгоритм Алгоритм Алгоритмы 
весьма: весьма 
алексей: Алексей 
связующий: связующим 
губернатор: Губернатора 
скан: скана 
принудительно: принудительно 
наш: наше нашем Нашей Наш нашему нашего наших наши нашей наша наш 
устранить: устранить устранен 
физический: физических 
выбирать: выбираем выбирать 
дилемма: дилемме 
обращение: Обращение обращением обращение 
плюс: плюсы Плюсом плюс плюсом плюсов 
слой: слоев слоях слоя слои 
масштабировать: Масштабировать масштабировать 
гк: ГК 
завершение: завершения завершение 
активность: активность Активность активностью 
прошлый: прошлом прошлой 
разделить: разделить 
узел: узлов узла узел узле узлами узлы узлу 
применить: применить Применить 
разнесение: разнесения 
ожидание: ожидания ожиданий 
бот: бота ботом бот 
то: то То 
всё: все Все 
учёт: учетом 
выгрузить: выгрузить 
жадность: жадность жадности 
фаза: фазы фаза фазу 
поверх: поверх 
одомашнить: Одомашнить 
описание: Описание описанием описания описание 
полноценный: полноценная полноценное 
транзакция: транзакциях транзакций транзакцию транзакции 
моделирование: моделировании моделирование моделирования 
присваивать: присваивает 
стоп: стоп 
зарубежный: зарубежного 
инструмент: инструментом инструмент инструменты инструментами инструменте инструментов инструмента Инструменты 
публикация: публикации Публикации 
редактор: редактором редакторе Редактор редактора редактор 
предназначить: предназначенные предназначена предназначенное 
проектовпосле: проектовПосле 
производительность: производительность 
особенно: особенно 
кощунство: кощунством 
удаление: Удаление удаления удаление удалении 
передача: передача передачи передачах 
обучение: Обучение обучение обучения обучению обучении 
аналитикабизнес: аналитикабизнес 
классификация: классификации Классификация 
конфликт: конфликта конфликтов 
отлично: отлично 
нахождение: нахождении нахождение нахождения 
монитор: монитора мониторе мониторов 
дать: дайте Данная данной данные даст дать данному 
сотрудничать: сотрудничать 
простота: простотой Простота 
провайдер: провайдер провайдеров провайдеры провайдера Провайдер 
альтернатива: альтернативу альтернативы альтернатива альтернативой 
традиционный: Традиционное традиционных традиционной 
начало: начале начало начала 
исследование: исследования исследований исследование Исследования 
персонал: персоналом персонале 
угроза: угрозах угроз угрозу угрозы 
получить: получите получила полученную Получите Полученные получил полученные получит получить Получить полученных получили полученный 
нацелить: нацелены нацелен 
сертифицировать: сертифицирована 
электронный: электронным электронная электронные 
сигарета: сигареты 
цепь: цепи 
приложение: приложение приложениями приложении приложения приложений приложению 
питер: Питер 
загрузка: загрузка загрузки 
настраивать: настраивать настраиваемых 
влияние: влиянием влияния влияние влияний 
песочница: песочница песочницу песочницы 
характер: характере характер 
динамический: Динамическая динамической динамических динамическим динамического Динамический динамические динамический динамическая 
очередной: очередного 
инсклассификация: ИНСКлассификация 
автоматизация: автоматизации Автоматизация автоматизацию 
опрос: опросе опросы 
эффективный: эффективен эффективное эффективную эффективных эффективной эффективного эффективные эффективный эффективному эффективнее 
случай: случаев Случай случае случаях случай 
сингапур: Сингапур 
задержка: задержек задержки задержками 
размещение: размещения 
сложно: Сложно сложно 
подключаться: подключаться подключающиеся подключаются Подключайтесь 
член: членов члены 
ротор: РОТОР роторы роторе ротора Ротор ротор роторов ротору 
взглянуть: взглянуть взглянем Взглянем 
остаток: остатка 
посчитать: посчитаем 
помощь: помощь помощью помощи 
замер: замера 
переноситься: переносится переносятся 
первый: Первым первая первых Первые Первый первом первого первым первый первое Первая первой первую 
экспоненциальный: экспоненциального экспоненциальная 
сам: сам самом самого самой саму сами 
нелинейный: нелинейные 
хранилище: хранилищах хранилищем Хранилища хранилище хранилищам хранилищ хранилища 
уничтожение: уничтожению 
хостинг: хостинг Хостинг 
московский: Московского Московская 
всплыть: всплывет 
пользователь: пользователям пользователю Пользователям пользователей Пользователь пользователи пользователями пользователя пользователь Пользователи Пользователю 
существовать: Существуют существует Существует 
устроить: устроена 
готовый: готового готовую Готовое готовыми готов готовы Готов готовых готовом готовое 
компьютер: компьютерах компьютеров компьютера 
обеспечение: обеспечения обеспечение 
перейти: перейти перейдите 
сфера: сферой сфере сферы сфера сфер 
запрос: запрос запросы запросов запросу запроса 
наверное: наверное Наверное 
заплатить: заплатим 
более: более Более 
элемент: элемента элементы элементов элемент элементу 
мобильный: мобильное мобильный мобильных Мобильная 
чудной: чудных 
вероятностный: вероятностных вероятностный вероятностно вероятностного вероятностному 
откровенно: откровенно 
основное: основном 
эффект: эффекты эффект 
оставаться: остается остаются оставаться 
балансировочный: Балансировочный балансировочных балансировочные Балансировочные балансировочного 
собрать: собрать собрана 
опцийобязательным: опцийОбязательным 
переход: переходом переходе 
регистрация: регистрации регистрацией регистрация 
механический: механических механической механического 
показывать: показывает показывать показывающей показывающие 
деплой: деплой 
радиальный: радиальном 
заблокировать: заблокированных 
внедрять: внедрять внедряю 
сначала: Сначала сначала 
повседневно: повседневно 
показатель: показатели показателя показателям показателях 
выполнять: выполняемой выполняемые выполнять выполняют выполняет выполняемых 
классифицировать: классифицированных классифицирована классифицировать классифицирован 
использовать: использован используют используете использующего используемых использовали использует использовать используя Используя используем Использовать использованы используемыми использующая используемое использующий используйте используемые используемой 
повышать: повышает повышая 
строка: строк строке строки строка 
равный: равный равных равными равна равны равные равен 
дизайнер: дизайнеры дизайнерами дизайнер дизайнерам 
модель: модель моделями моделям модели моделей моделью Модель 
экземпляр: экземпляра Экземпляр экземпляр 
внушительный: внушителен 
оказаться: Оказалось оказалось окажется 
детально: детально 
отрицательный: отрицательный отрицательных 
загружаться: загружаются 
хватать: хватает хватало хватать 
взаимосвязь: взаимосвязях взаимосвязей взаимосвязь 
условный: условного Условной 
неплохой: Неплохая 
офис: офис 
компенсация: компенсации 
автор: автора Авторы авторам автор Автор авторы 
москва: Москве Москва 
сервис: сервис сервисов Сервис сервисом сервисами сервисы сервиса сервисе 
книга: книга книге 
организация: организациями организациях организации организаций 
встраивание: встраивания 
схема: схеме Схемы схему схема схемой схемами Схема схемы схем 
спроектировать: спроектировать 
исходный: исходная Исходные исходных исходным исходный исходную исходные исходном Исходный исходному 
ложный: ложное ложно ложным Ложные 
вращаться: вращается вращаться вращающиеся вращающихся 
запись: записей записях записи запись 
файловпри: файловПри 
опора: опоры опора опорах ОПОРЫ опор 
ввести: введены ввести 
избежать: избежать 
полярный: Полярное 
конфиги: конфиги 
ситуация: ситуаций ситуациях ситуации 
система: системах Система системой систему системе систем системам Системы СИСТЕМА система системы 
как: как Как 
научиться: научилась научатся научится научился 
новостейзаключениекогда: новостейЗаключениеКогда 
выделить: выделенную выделенная выделенных выделить выделенные 
тег: Теги тег тегов 
несложно: несложно 
какой: какому какого Какие какую Каким какие какой каких какая 
сорт: сорту 
установка: установку установки Установка установке установка 
соответственно: соответственно Соответственно 
изобретать: изобретать 
параметр: параметр параметрами параметром параметрам Параметр параметров параметры 
статья: Статью статьи статью Статьи статьей статья статье 
кто: Кто кто кого кому Кому 
объясняться: объясняется объясняются 
простой: простое простых Проще простым Простой проще простоя простой 
увы: Увы 
учитывать: учитывать Учитывая учитывая учитывает 
языкахзапрос: языкахЗапрос 
деформировать: деформирован 
подход: подходу подходе подхода подходом подход подходов 
характерный: характерен 
ваш: ваша ваши вашему вашего ваших Ваше вашими ваш Вашей вашем вашим вашей Ваш Ваши 
проведение: проведении проведения проведению 
токен: токен 
смочь: сможет смогли сможете смогут Сможет 
неохотно: неохотно 
глубина: глубину 
сберу: Сберу 
ключ: ключами ключей ключи Ключи ключом ключ Ключ 
конференция: конференции Конференции 
теоретически: теоретически Теоретически 
неподходящий: неподходящие 
больший: большие большей большего Большим большим большими БОльшие больших 
код: коде код коды коду кодом кода 
копать: копать 
кластеризациипри: кластеризацииПри 
самый: самую самое самые самым самыми самых самый 
интегратор: интегратор 
телеграм: Телеграм телеграм 
почтовый: почтовой почтовые почтового почтовым почтовый почтовом почтовых Почтовые 
сводка: сводку 
перплексия: перплексия 
обновляться: обновляется 
например: например Например 
скорость: скорость скоростях скорости 
великоватый: великоват 
представлять: представляемых представлять представляет Представляю представляющие 
другой: другим другие Другими другого Другие другой Другой других другими другому 
внимательность: внимательности 
коррекция: коррекция коррекцию коррекции 
минута: минут минуты 
отслеживать: отслеживает отслеживать 
обновление: обновления обновлений обновлением обновление 
стек: Стек стек стека 
разовый: разовые 
способствовать: способствуют 
разочарование: разочарование 
сутки: сутки 
внутренний: внутреннюю внутренний внутренних внутренней 
следующий: следующий следующей следующую следующем следующего следующие следующих следующим следующими следующее 
основный: Основными основного Основное основными основным Основным основных Основная основная 
решение: решений решение решениями решениях решения Решения Решение 
иметь: имеют иметь имел имеете имеет имею имеющие имели имеем 
линейный: линейных линейной Линейные линейную линейными 
неопределённость: неопределенностью неопределенности 
быстрый: быстрых быстрые быстрый быстрее быстр быстрое Быстрая Быстрый быстрой 
направить: направлен направлена направленные направленная 
получение: получения 
блин: блин 
конструктор: конструктор конструкторов 
отличать: отличать 
ребята: ребятам 
клик: клике 
политик: политик 
намерить: намерены 
когда: когда Когда 
рождение: рождения 
взода: взода 
почасовой: почасовых 
описать: описаны описанный описанные описать описали описан 
корзина: корзин корзину 
завершить: завершен завершить 
дизайн: дизайн дизайна Дизайн 
активный: активной Активное активная активных активным активного активное 
заменять: заменяющие заменяет Заменяет 
мера: мерой мера мерами мере 
интерцептор: интерцепторы 
асинхронный: асинхронной асинхронный асинхронную 
наварка: наваркой 
консоль: Консоли консоль консоли 
предпочтение: предпочтений 
обработчик: обработчику обработчик обработчиком обработчика 
должный: должно должен должна должны 
раскрой: раскроем 
решить: решить решим решили решены решил 
удивиться: удивлюсь 
лайфхак: Лайфхаки 
оставить: оставленных оставил оставим оставивших оставить 
тяжесть: тяжести 
качество: качеству качества качеством качестве качеств качество Качество 
быть: был было Будете будет будем Была Будем быть была Будучи Будьте будете были суть будут 
устранение: устранение устранения устранением устранению 
блокировать: блокирует 
вокруг: вокруг 
обучить: обучить обучена 
отображение: отображение отображения отображением 
исследователь: исследователя исследователей 
совместный: совместную 
бесконечно: бесконечно 
предпринимать: предпринимать 
миллион: миллионы 
машина: машине Машины машиной машины машинам машин 
альфа: Альфа 
большинство: Большинство большинстве большинство 
продолжать: продолжают продолжать продолжает 
ага: ага 
глубокий: глубокое глубоком глубокого 
тезис: тезиса 
захват: захвата 
фреш: Фреш 
эксплуатация: эксплуатации эксплуатация 
пентеста: пентеста 
расчёт: расчета расчетов расчет расчетах 
глобальный: глобальным Глобальный глобальная глобальный глобального глобальные 
барометрический: барометрического 
врач: Врач врача 
упрощение: упрощение упрощения упрощением 
байесовский: байесовских Байесовские байесовскими байесовской байесовские 
налаче: налаче 
научный: научный научных научного научные 
клиент: клиенты клиентам клиент клиентами клиента клиентов 
редко: редко 
год: годом годов год года лет году 
раста: раста 
рассчитать: рассчитать рассчитано 
включить: Включить включить включены включено 
речь: Речь 
мощность: мощностей Мощности мощностях мощности 
разработчик: разработчиками разработчики разработчик Разработчик разработчиков разработчика разработчикам 
бакета: бакета 
иероглиф: иероглифами 
мы: нам нас Мы мы Нам 
пора: пор 
зрение: зрения 
отказаться: отказалась отказаться 
способность: способности способностью 
редакция: редакциях редакции редакция 
успех: успехом успеха 
короткий: коротка короткое коротких короткий 
объект: объект объекты объекте объекта объектов 
ассортимент: Ассортимент 
повышение: повышении повышением повышения 
себя: собой себя себе 
чтение: Чтение чтение 
предусматривать: предусматривает 
неисправный: Неисправный 
задачипосле: задачиПосле 
переводчик: Переводчик переводчика 
покупка: покупки покупку 
предположим: Предположим 
установить: установлены установлен установить 
прибор: прибора прибор приборов приборы 
появление: появления появлению 
отрасль: отрасли отраслям отраслях отраслей 
век: века 
невозможно: невозможно 
каждый: каждая каждому каждым каждый каждой Каждый каждое Каждая каждого 
рекомендовать: рекомендуемый рекомендовали рекомендуем 
один: одних Один одни одном одна один одним одно Одна одной одного одному одну 
близкий: ближе близки Ближайшей близка 
десктопных: десктопных 
привести: привести приведены приведен приведет приведу приведенном привела привели 
требование: требование требованием требованиями требованиям Требования требования требований 
направление: направления направлению направлении направление 
встроить: встроенный встроенные встроены 
конструкция: конструкция конструкцию конструкции конструкцией 
касперский: Касперского 
спасать: спасаем 
оптимальный: оптимальный оптимальную 
характеристика: характеристикой характеристики характеристиками характеристик 
ухудшаться: ухудшается 
конкретный: конкретные конкретного конкретной конкретных конкретную 
вычислительный: вычислительных вычислительный вычислительную вычислительные 
концепция: концепцию Концепция концепции 
интересовать: интересует интересующие 
тип: Тип типов тип типа типы 
приглашать: приглашаем 
бесполезно: бесполезно 
репозиторий: репозиторием репозитории репозиторий репозиториям репозиториями репозиториев репозитория 
передавать: передающих передавали передавать передают 
оставлять: оставлять оставляет 
обработка: обработкой обработка Обработка обработки обработку обработке 
категория: категории категориях категорию Категории 
срабатывание: срабатываний 
перемещаться: перемещаются перемещаться 
достоинство: Достоинством 
жар: жар 
класс: класс классов классы классах Класс класса классу классами 
интеллектуальный: интеллектуальной 
одинаково: одинаково 
школьный: школьной 
квантизовать: квантизовать 
оборудование: оборудование Оборудование оборудования 
подключить: подключить подключит подключенных 
широко: широко Широко 
стараться: стараемся Стараясь 
паттерн: паттерном паттерны 
африка: Африки Африке 
день: дни дня день 
повысить: повысить 
добавлять: добавлять добавляю добавляем добавляет добавляемого добавляя 
применять: применять применяют применяя применяемых 
экспертный: экспертные 
сбалансированный: сбалансированном сбалансированных 
реальность: реальности 
значение: значения значении значениям значение значений значением 
типовой: типовых 
виброаселерометры: виброаселерометры 
нести: нести 
над: над 
открытый: Открытых открытые Открытое открытую открытых открытым 
новый: новую новые новыми новая новее новое новый Новые новых нового новой Новая новым Новый 
последний: последнее последние последнего последних Последние последними последней последний 
бороться: борется бороться 
текущий: текущего текущее текущий текущим текущем текущей текущие 
положение: положение положения положении 
муфта: муфту 
ссылка: ссылка ссылку ссылке ссылкой ссылки 
стремиться: стремитесь стремимся стремятся стремящийся 
накрутить: накручены 
разбитый: разбитых 
продукт: продуктами продукту продукте продукт продукта продукты продуктом 
недовольство: недовольства недовольство 
задаваться: задаются 
заканчивать: заканчивая заканчивали 
служба: службу службам службе 
внимание: внимания вниманию внимание 
крепиться: крепится 
дискуссия: дискуссия 
половина: половина 
автоматический: автоматический автоматической автоматическая автоматического автоматические автоматическими автоматическое 
дополнительный: дополнительной Дополнительная дополнительных дополнительными дополнительную дополнительного дополнительная 
блокчейн: блокчейн 
момент: момента момент моменту 
начинающий: начинающих 
осторожный: осторожны осторожным 
затрата: затрат затраты 
буквально: буквально 
контейнер: контейнера контейнеров контейнер 
структурный: структурные 
степень: степень степенями степени 
тяжёлый: тяжелую тяжелой 
линия: линии линий 
метка: метку меток метка Метка меткам 
чат: чата чате Чат чат чаты 
месяц: месяцем месяца месяцев месяц 
плохой: плохая плохой 
востребовать: востребованный востребованным Востребован 
бдна: БДНа 
турбина: турбин 
ставить: ставить ставит 
свой: своей свои своем своим своего своими своих свой свое свою 
хотя: Хотя хотя 
эксплуатационный: эксплуатационную 
эксперимент: эксперимент экспериментов эксперимента 
сохранять: сохранять сохраняет 
среднеквадратичный: среднеквадратичная среднеквадратичное Среднеквадратичная Среднеквадратичное 
устройствапри: устройстваПри 
восьмёрка: восьмерка 
маска: маске маски 
надвигаться: надвигающаяся 
дзен: Дзен 
сравниваться: сравниваются 
отбрасывать: отбрасывая 
постраничный: постраничное 
средний: среднее средней Средний средняя 
ревьюверы: ревьюверы 
интерпретировать: интерпретировать 
заявка: заявок заявки 
программный: программное Программные программному программными программные программных программного 
амплитуда: амплитуда амплитуды амплитуду 
генерироваться: генерироваться генерируется 
голова: головой голову голове 
внедрение: внедрении внедрение Внедрение 
интеграция: интеграции Интеграция интеграция 
пых: пыха 
руководство: руководствами руководство руководства руководству 
теперь: Теперь теперь 
обзор: обзоров обзор Обзор 
задонатить: Задонатить 
запретить: запретить запрещено запрещен запретим 
храниться: хранится храниться хранятся 
порт: портах портов порты порт портам 
нагрузка: нагрузки нагрузками нагрузка нагрузкой 
остальной: остальным остальных Остальные остальными остальные 
завысить: Завышенные 
понимание: Понимание понимания понимание 
отличаться: отличается отличаются 
разумно: разумно 
специализировать: специализированную специализированные специализированное 
писать: Пишите писать Пишу пишет пишите писала пишут пишете 
двигатель: двигателе двигателей 
черепенников: Черепенников 
деформироваться: деформируются 
уникальный: уникальным уникальный уникальные 
логирование: логирование 
крутейшая: Крутейшая 
неудачно: неудачно 
итак: Итак 
выполнение: Выполнение выполнении выполнению выполнение выполнения 
формулировка: Формулировка 
самостоятельный: Самостоятельное 
коэффициент: коэффициенты коэффициентов коэффициента Коэффициенты 
несколько: Несколько несколько нескольких 
вот: Вот вот 
пренебречь: пренебречь пренебрегла 
уж: уж 
веб: Веб веб 
устраняться: устраняются устраняется 
луна: Луны 
сэкономить: сэкономить 
развитие: развитием Развитие развитию развитии развития развитие 
увеличивать: увеличивает 
допуск: допуски допуском допусков допуска 
вверху: вверху 
распределяться: распределяется 
впечатляющий: впечатляющими впечатляющие 
вид: вида вид виде видами виды видов Виды виду 
улучшать: улучшает улучшая улучшают 
подряд: подряд 
линейность: Линейность линейности линейность 
число: числами числа числе чисел число числу 
адаптер: адаптер Адаптер адаптерами Адаптеры адаптера адаптеров 
неудача: неудачу 
сила: силах сил силой сила Силы силу силы силам 
кроме: кроме Кроме 
строкиболее: строкиБолее 
атака: атак 
аналог: аналог аналоги 
массив: массивов массив массива 
математический: математические математической математических математический 
облако: облака облаке облако Облака 
очень: Очень очень 
изолировать: изолированный 
тема: темы темам тема теме 
админ: админы 
финтехом: финтехом 
поддерживать: поддерживают поддерживать поддерживает 
анализ: анализом анализу Анализ анализе анализа анализ 
подложка: подложка 
менее: менее 
награда: награду 
интуитивный: интуитивные 
выбрать: выбранные выбранному выберите выберем выбрал выбранных выбрали выбрать 
удовольствие: удовольствия удовольствием 
автоматизированный: автоматизированного автоматизированный автоматизированным автоматизированное 
партнёр: партнеру партнер 
записываться: записывается записывались 
необходимый: необходимое необходимой необходим необходимые необходима необходимую 
погрешность: погрешностей погрешность погрешности 
уместить: уместить 
написать: написали написана написать написал напишите написано 
тот: та той тому ту том те того тот теми тех 
георгий: Георгий 
осуществляться: осуществляется 
блокироваться: блокируется 
среди: Среди среди 
идея: идеями Идея идея 
требовать: требовали требуемых требующих требует требовала требуют 
потребитель: потребителей потребителем потребителями 
груз: грузы грузов груз груза 
ошибка: ошибок ошибки ошибку ошибкой ошибка 
зарегистрировать: зарегистрирована Зарегистрирована зарегистрированные Зарегистрирован зарегистрировал 
впрочем: впрочем Впрочем 
заноситься: заносятся 
управление: Управление управление управления управлению 
совсем: совсем 
менять: Меняем менять меняя меняет 
читать: читать 
порог: Порог порог 
инструкция: инструкции инструкцию инструкциями инструкциям инструкций 
симметричный: симметричный симметричных симметричен 
название: названием название Название названия 
лицензия: лицензия лицензиями лицензий Лицензии лицензии 
демо: демо 
абсолютный: абсолютной абсолютная 
дорезонансных: дорезонансных 
целочисленный: целочисленных 
надёжность: надежность 
положиться: положиться 
угол: углы угла 
уравновесить: уравновешенным 
иметься: имеющимся имеющихся имеется 
джентльменский: джентльменский 
финансы: Финансы финансов 
батча: батча 
подключиться: подключиться 
немало: немало 
кортеж: кортеж 
вячеслав: Вячеслав 
загружать: загружаемых загружать загружает 
потратить: потратили 
помогать: помогая помогают помогает помогать помогающих Помогаем 
технология: технологией технологиям технология технологий технологии технологию технологиях Технологии 
поддержание: поддержанием 
появиться: появиться появится 
непрофессиональный: непрофессиональный 
сторонний: сторонних сторонние 
нибудь: нибудь 
масло: маслом 
длинный: длинные длиннее длинных 
сэмплы: сэмплы 
четыре: четыре 
некоторый: некоторой Некоторые некоторые некоторых 
переставать: перестает 
лапа: Лапы 
обучениясейчас: обученияСейчас 
антон: Антон 
иначе: иначе Иначе 
зависимый: зависимые 
сентябрь: сентября 
этот: этот Этот этих этому этой эту этими Эти эти Эта эта 
архитектура: архитектура архитектурой архитектурах архитектуры архитектуру архитектур 
область: область областях области 
тасков: тасков 
интеллект: интеллектом интеллекту интеллекта интеллекте интеллект 
разный: разную разные разными разной разный разных 
нечто: нечто 
знать: зная знают знает знаю знаете знать 
ли: ли 
спектральный: спектральным 
обязательный: обязательным 
топика: топика топик 
распределённый: распределенного 
формироваться: формируется 
отличияинтерфейс: отличияИнтерфейс 
удалить: удалены 
неделя: неделю недели 
мир: мире мир мира миру 
повторно: повторно 
полный: Полный полон полную полного Полную 
вебинар: вебинар 
векторный: векторные векторной 
соотносить: соотнося 
считаться: считаются считались считается 
гражданин: граждан граждане 
нижний: Нижняя нижний 
потом: потом 
проектероль: проектеРоль 
несуществующий: несуществующий несуществующего несуществующей 
крупный: крупный крупнейших Крупнейший крупные крупной крупных Крупнейшее 
проблематика: проблематике 
чертовски: чертовски 
зубчатый: зубчатых 
реальный: реальном реальных реального 
среда: среды 
заключение: Заключение 
порция: порцию 
узкий: узкий узких узкого 
увеличение: увеличении увеличение увеличению увеличения 
медленный: медленный 
становиться: становилось становятся становится 
офисный: офисной 
нескрытый: нескрытых 
середина: середине 
распространяться: распространяться распространяются распространяется распространяющихся 
окружение: окружение 
звезда: звезду 
сильный: сильном 
условие: условие условиях условий 
секретный: Секретный секретный 
воздержаться: Воздержался Воздержались 
занять: заняла занял займет 
ключевой: ключевое Ключевой ключевым ключевые ключевую 
хотеться: хочется 
подстановочный: подстановочным 
иллюстрация: иллюстрации 
доступно: Доступно доступно 
выбег: выбеге 
дамп: дампа 
выход: выхода выходе выход 
вырасти: выросли вырастут 
услуга: услуг услугам услуги услуга 
множество: множеством множества множеству множество 
компилировать: компилирует компилировать 
десятка: десятки 
владимир: Владимир 
токена: токена 
захабренный: Захабренный 
преобразование: Преобразование преобразовании преобразования преобразование 
доходность: доходность 
эталонный: эталонным 
блог: блогов Блог блоге 
признак: признаком 
включаться: включаться включаются 
расширение: расширений расширения расширение Расширение расширении 
подсветить: подсветить 
невращающихся: невращающихся 
посмотреть: посмотреть посмотрим 
операция: операция операциях операций операции операцию 
отмечаться: отмечалось отмечается 
хаб: хаб Хаб 
применяться: Применяется применяется применяются применяться 
америка: Америке 
лобовой: лобовое 
санкция: санкциях 
устанавливать: устанавливать устанавливали 
насчёт: насчет 
обход: обход обхода 
кибербезопасность: кибербезопасность 
сбой: сбою сбоев сбои 
оценить: оценить 
оценкипри: оценкиПри 
доступный: доступна доступен доступные доступных доступны 
величина: величины величин величиной Величина величине величина 
заказ: Заказ заказ 
связанный: связанной связанный связанную связанных связанными 
метрика: метрикой метрика метрики Метрика метриками 
первичный: первичный первичном первичные первичного первичное 
наблюдать: наблюдали наблюдаемых наблюдаем 
производиться: Производится производиться производится 
ресурс: ресурса ресурсами ресурс ресурсов ресурсам ресурсы 
объявление: объявления 
сравнение: сравнения сравнению сравнение сравнении Сравнение 
сторона: стороны сторону стороной сторон стороне сторонами 
лицензионный: лицензионного лицензионная 
затем: затем Затем 
знание: знания знаний 
реализовать: реализует реализовать реализовано реализующего реализована реализованы реализован реализовали 
пакетный: пакетной пакетно пакетная 
рис: рис 
популярный: популярным популярными популярных популярное популярный популярные 
просто: просто 
эпицикл: эпициклов 
плоскость: плоскостях плоскость плоскостью плоскостей плоскости 
манипулятор: манипулятора 
обрабатываться: обрабатывается 
тенденция: тенденций тенденция тенденции тенденциями 
уменьшить: уменьшим уменьшить 
предлагать: предлагают предлагает предлагаем Предлагаем 
взаимодействие: взаимодействия взаимодействие 
выстраивание: выстраивания 
против: против Против 
бета: бета Бета 
многие: Многие многие 
перестать: перестали 
выбранно: выбранно 
принцип: принципу принципа принципов принципе 
канал: каналу канал канале 
место: местах места место мест Место месте 
оборачивать: Оборачивать оборачивать 
личный: личных личный личного личные 
центральный: Центрального центральной 
совершенствовать: совершенствовали совершенствовать 
допустимый: Допустимые допустимые допустимого 
мусор: мусора 
заменяться: заменяются 
изменить: изменен измененная 
инфраструктуразаконодательство: инфраструктураЗаконодательство 
сборка: сборку сборки сборке 
платёж: платежей платежа платежами 
кисть: кисти кисть 
куда: Куда куда 
допустить: Допустим 
бакеты: бакеты 
полезный: полезные полезная Полезное полезных Полезная полезным полезной полезен 
ждать: Ждать ждал ждут ждем ждать 
износ: Износ износу 
пройти: прошло пройти Прошло 
артификации: артификации 
измерительный: измерительно измерительной измерительный 
находить: находят находить находит 
текст: тексты текста текстов текст 
целое: целого целом 
ускорение: ускорение ускорении 
получаться: получаются получается 
считать: считает считаем считали считать 
выхлоп: выхлоп 
оправдать: оправдана 
инсталляция: инсталляциями инсталляцию 
давать: давайте давать Давайте дает 
зависимость: зависимостей зависимость зависимости 
адаптироваться: адаптироваться 
погрязнуть: погрязла 
бэклог: бэклог 
отправить: отправит отправьте отправлены отправлено 
состояние: состояние состоянию состоянии состояния 
чуть: чуть 
сетиавтоматическое: сетиАвтоматическое 
минимальный: минимального минимальный 
проголосовать: Проголосовать Проголосовали 
комментатор: Комментатор 
провести: провести проведенных провели проведенную 
помимо: помимо Помимо 
шаг: Шаг шагах шаг шаге 
виртуальный: виртуальное виртуальные Виртуальная Виртуальные 
посвятить: посвященной посвященные посвящена 
отписаться: отписаться 
программирование: программирование Программирование программирования 
аспект: аспекты аспектов аспектам 
колесо: колеса колесо 
обспечивать: обспечивать 
частота: частотах частоте частоту частота частотой Частота частоты 
официальный: официальной 
собес: собесах 
страница: страниц странице страницы страницу 
шлюз: шлюзами 
максимально: максимально 
путь: пути путь 
системный: системным системный системной Системное Системный 
плоский: плоских плоской 
присоединяться: присоединяйтесь 
сложный: сложным сложный сложнее сложной Сложный сложные сложных сложная сложном 
говорить: говорит говоря говорят говорили говорю Говоря говори говорите 
паскаль: паскаля Паскаль 
вероятность: вероятность вероятности 
сей: сих 
тренировать: тренируемых тренировать тренируемый 
сообщить: сообщить 
опция: опций Опции опции опция 
картина: картин 
позволить: позволит позволили 
совместить: совместить 
короткозамкнутый: короткозамкнутых 
конкретно: конкретно 
приложить: приложены приложенный 
имя: имен имя имени именам именем Имя 
российский: российского российское российский российских российским российские российской российская 
светящийся: светящихся 
директива: директивы 
общий: общего Общее общих общее Общая общие общим общей общему общем 
пациент: пациент пациента 
опыт: опыт опытом Опыт 
заинтересованный: заинтересованные заинтересованными заинтересованных 
сравнивать: сравнивать сравнивает 
информация: информацией информация Информация информацию информации 
регулярный: Регулярное регулярного регулярное 
эмулятор: эмулятор 
возвращать: возвращаемого возвращает возвращают 
экспорт: экспорта экспорты Экспорт 
изображение: изображений изображении изображения 
сбор: Сбор сбор сборе 
совпадение: совпадения совпадений совпадение 
генетический: генетические генетического 
просмотр: просмотре просмотра просмотров 
питон: питоном питону питона 
сценарий: сценарию сценариев сценарий 
подлежать: подлежит подлежат подлежащий 
австралия: Австралии 
копия: копии копий 
повториться: Повторюсь повторилась 
противоположный: противоположны противоположные противоположный 
экосистема: экосистемы экосистеме 
отработать: отработать отработанные 
современный: современном современное современных современной современный 
перехватывать: перехватывать перехватываем Перехватываем 
рассчитывать: рассчитывать рассчитывает 
нейросетей: нейросетей 
сообщество: сообществе сообщество сообщества 
иногда: Иногда 
наименование: наименование 
затравкахчтобы: затравкахЧтобы 
событие: событиями событиях событие событий событию Событие события 
уступать: уступает 
задачапредставим: задачаПредставим 
локальный: Локальная локальном локальная 
администраторадля: администратораДля 
ранний: Раньше раньше 
база: базу база База базой базами базы базе Базы баз базам 
заключениеэта: ЗаключениеЭта 
сталкиваться: сталкиваемся сталкивается сталкиваются 
маршрут: маршрута маршрут 
отразить: отражено отразить отражены 
избыточный: избыточным 
вдоль: вдоль 
выработка: выработки 
правильный: правильный правильного правильное 
поверить: поверить 
универсальный: универсальными универсальным универсальных универсального 
управляемый: управляемой управляемым 
роль: Роль роли роль 
предел: пределами предел пределах пределы предела 
изготавливаться: изготавливаются 
засканировали: засканировали 
индексация: индексация индексации 
михаил: Михаил 
идентификатор: идентификатор 
авторизация: авторизации 
запрограммировать: запрограммированные 
курс: курсы курса курсе Курс курсов 
записать: записанных записанные 
частый: Чаще чаще 
измерять: измерять измеряет измеряющие 
нестандартный: нестандартных 
прямо: прямо 
экономист: экономисты 
застрять: застряли 
штраф: штрафов 
осмыслить: осмысленного осмысленное 
версия: Версия версию версии версий версия 
небольшой: небольшая Небольшие небольшую небольших небольшое небольшой 
сработать: сработал сработала 
сотня: сотни сотнями 
графический: графическим графические графической графического Графический графических графическом графический 
написание: написания 
неполный: неполное 
развитой: развитой развит 
сделать: сделайте сделаем сделали сделает Сделай сделать сделал Сделав 
задача: задач задачами задача задаче задачей Задачей задачи задачу 
распознавание: распознавании распознаванием распознавания 
стагнация: стагнации 
что: чему что чего Что 
удовлетворить: удовлетворить 
раз: раз разу раза Раз 
часть: Часть частей часть частях частью части 
соцсеть: Соцсеть соцсетях 
шаблонный: шаблонных шаблонные шаблонный 
андрей: Андрей 
внурти: внурти 
почему: почему Почему 
установленный: установленных установленные 
умолчание: умолчанию 
словарь: словаре словаря Словарь 
представитель: представителями представители 
кмк: кмк 
собираться: собираются 
кластер: кластера кластер кластеру 
пробный: Пробный пробных пробного пробные пробный 
джет: Джет 
масса: масса масс массой массу Массы массы 
сервер: серверов серверу сервера серверами сервер Сервер сервере серверы серверах сервером 
сканирование: сканирование сканировании сканирования 
сибур: СИБУР 
действительно: действительно 
мошеннический: мошенническими мошеннических 
учиться: Учимся 
вода: вода Вода 
финансовый: финансового финансовыми финансовых 
читатель: читателей 
надёжный: надежного надежен надежном надежным 
программист: программист программиста программистам Программист 
неактуальный: НЕактуальный неактуальными Неактуальные 
пример: примером примере примеры примеру примеров Примеры пример Пример 
пятый: пятой 
проходить: проходящая проходит 
планшет: планшеты 
неотъемлемый: неотъемлемой 
привлечь: привлечь 
главный: Главная главные главной Главные 
наиболее: наиболее Наиболее 
или: или Или ИЛИ 
автоматика: автоматика 
известный: известной известного известны известными известный 
читаемый: читаем читаемым Читаем 
посетитель: посетителя посетителями посетителей 
комплексный: комплексного 
обёртка: оберткой обертка Обертка 
механизм: механизм механизмам механизмов механизма механизмах механизмы 
добавление: добавление Добавление добавления 
показать: показать Показать показал покажем 
разрабатывать: разрабатываю разрабатывает разрабатываем разрабатываемых 
онлайн: онлайн Онлайн 
бакетаидентификатор: бакетаИдентификатор 
твиттер: Твиттере 
компания: компаний компаниях компании Компании компания компанию компаниям Компания 
друг: друг друга другом другу 
ентырнэты: ентырнэты 
николай: Николай 
тигран: Тигран 
называться: называются называется 
рассуждение: рассуждений рассуждения рассуждению рассуждениями 
количество: количества количестве количеством количество количеству Количество 
залпатентованиенаучно: залПатентованиеНаучно 
рассказываться: рассказывается 
определение: определения Определение определении 
чтобы: чтобы Чтобы 
трансформер: трансформер 
машинный: машинное Машинное машинном машинного машинному 
уведомление: уведомления Уведомление уведомлений уведомление 
гибридный: гибридных 
начать: начали начнет начать 
медиа: медиа 
гигант: гиганта 
обмотка: обмоток 
патентование: патентованием Патентование 
заключаться: заключается заключалась 
тут: тут Туту Тут 
впереди: впереди 
реквесты: реквесты 
зарабатывать: зарабатывать 
распространить: распространенных распространены 
рад: Рад 
право: право прав правах права 
редактировать: редактируемой 
анализировать: анализирует анализировать анализируют 
верный: верных верна 
батчи: батчи 
внимательный: Внимательный внимательных внимательный 
уверить: уверены 
техник: техниками 
нативный: нативную нативных 
контрфактические: контрфактические 
десятилетие: десятилетия десятилетий 
национальный: национальная 
окружающий: окружающей 
модуль: модулей модули модуль модуля модулем модулю 
работа: работой работы работами работу работа работе Работа 
тоновый: Тоновая 
удобно: удобно 
звать: зовут 
нож: ножах ножа 
мина: мин 
находиться: находятся находиться находящаяся находится 
котенков: Котенков 
регулятивный: регулятивная 
попасть: попал 
лишить: лишите 
финтеха: финтеха 
реестраитогинесмотря: реестраИтогиНесмотря 
видение: видения видение 
малый: меньшую малых 
неуравновешенность: неуравновешенность неуравновешенностью неуравновешенности 
от: От от 
электроника: электроника Электроника электроники 
подаваться: подаются 
выявить: выявленных выявить 
втулка: втулка 
анализатор: анализатора 
перед: перед 
великий: величайшие 
понимать: понимал понимают понимать понимает понимаю 
хитрость: Хитрости 
размер: размеры размер размера Размер 
ручной: ручной ручным Ручная Ручное 
пушкин: Пушкин 
обмен: обмена 
точно: точно 
вычисление: вычислений вычисления 
уйти: ушли 
проектыв: ПроектыВ 
узнать: узнали узнать узнал узнаем 
постоянно: постоянно Постоянно 
квантизованная: Квантизованная 
карта: Карта карте карта карту картой карт карты 
метаданные: метаданными 
демонстрация: Демонстрация демонстрации 
перспективный: Перспективный 
целый: целыми целый целых целой целые 
будущее: Будущее 
изложить: изложен 
фикс: Фикс фиксов 
реклама: рекламу 
оценка: Оценка оценки оценку 
остановить: остановить 
рассказывать: рассказываю Рассказываем рассказывали 
продажа: продаж продажи 
даже: даже Даже 
путём: путем 
блочный: блочная 
прогнозный: прогнозные 
стандарт: стандартом стандарта стандартов стандарте 
сложность: сложностей сложности 
изготовление: изготовления 
повторный: повторное повторном повторным повторные 
смысл: смысла смысл Смысл 
экран: экранами экране экран 
неуравновшенных: неуравновшенных 
отредактировать: отредактированная отредактируем 
доработать: доработанные доработали доработала 
слыхать: слыхали 
фича: фичах фичи 
контейнерустановите: контейнерУстановите 
отличный: отличным отличные Отличным отличный 
производить: производить 
бумажный: бумажных 
числовой: числовых 
пространство: пространства пространстве пространство 
дополнять: дополнять 
сниматься: снимается 
ответить: ответить ответили ответил Ответить 
публиковать: публикуют публикует 
использование: использованием использование использовании использования Использование 
она: она Она ее Ее ей ней ею нее 
корректировать: корректирующей корректирующие корректирует корректирующих 
участник: участников участники участникам участниками 
моделейпреимущества: моделейПреимущества 
действие: действия действию действием действие действиями действий 
дождь: Дождь 
правый: правой 
исследованийассоциация: исследованийАссоциация 
знакомый: знакомы 
усовершенствовать: усовершенствованной усовершенствованная 
цель: целей Цель цели целях целями цель целью 
низкий: Низкий низкой низкий 
сдвинуть: сдвинем 
райан: Райан 
инстанцирование: инстанцирование Инстанцирование 
кроссинговер: кроссинговер 
возникнуть: возникла возникли возникнет возникшие возник возникло 
активно: активно 
уровень: уровни уровне уровень уровня уровню Уровень уровнях 
вал: валов вала 
текстовый: текстовыми текстовый 
чумаков: Чумакова 
различный: различных различными различные 
коррелирования: коррелирования 
налёт: налету 
недавний: недавней 
контактный: Контактная 
планировать: планировать планируем 
связь: связей связи связь связях 
успешный: успешное успешным успешной 
дальнейший: дальнейшей дальнейшем 
распространение: распространение распространения распространению 
оцениваться: оцениваться 
кривая: кривых кривые кривой 
предложить: предложить предложили предложенным Предложить 
разместить: размещенных 
начинать: начиная начинает начинают 
опубликовать: опубликовала опубликовали 
свойство: свойство свойством свойству свойства 
мебель: мебели 
фактор: фактор факторов 
перегрев: перегрева 
снова: снова 
покупать: покупает покупали 
лента: лента 
инженерный: Инженерные 
некоммерческий: некоммерческого 
приведение: приведения 
популярность: Популярность популярность 
выключить: выключить 
указание: указанием Указание указание указания 
убедительный: убедительные 
скрытый: скрытых скрытого скрытые 
незначительно: незначительно 
легко: Легко легко 
предотвратить: предотвратить 
релевантный: релевантные 
транслировать: транслировать 
пуантилизм: пуантилизма 
основываться: основываясь 
измеряться: измеряются измеряется 
сокет: сокетами 
прозрачный: прозрачно прозрачной 
пестрить: пестрят 
известно: известно 
зло: зло Зло 
покинуть: покинули покинувший покинул 
запоминать: запоминает 
безвременно: безвременно 
страновой: страновых 
график: графику графиков График график 
зуб: зубьев 
здравый: здравого здравый 
минус: минусы минус 
учебный: Учебный 
улететь: улетели улетит 
рынок: рынках рынков рынке рынка рынок 
сравнить: сравнить 
различие: различия 
потеря: потери потере потерь потеря потерю 
исправить: исправлено 
ремонт: ремонту ремонт 
расчитана: расчитана 
неправый: неправы 
новичок: Новичку новичкам 
оптимизация: оптимизация Оптимизация оптимизации 
неизменяемый: неизменяемым 
диагностировать: диагностировать 
петербург: Петербург 
аугментация: аугментации 
средство: средств 
развиваться: развиваться развивается 
совмещение: совмещения 
подгонка: подгонка подгонкой подгонке 
произойти: произойдет произошло 
понятный: понятные понятный понятной 
программированияязыки: программированияязыки 
упругий: упругих 
гроза: гроза 
профессиональный: профессиональные Профессиональные профессиональная 
фраза: фразы 
сечение: сечения 
темп: темпами 
малярия: малярию малярией малярия 
сервисовтестирование: сервисовТестирование 
прикладной: прикладного прикладном прикладную 
цвет: цветом цвета 
использоваться: использоваться используется используются использовалось 
вакансия: вакансии вакансия вакансий 
центробежный: центробежным центробежные центробежную Центробежная центробежных центробежной центробежная 
устройство: устройств устройства 
статический: статические статический статических статическим Статический статической статического Статические статическом 
превзойти: превзойти 
инициализация: инициализации 
изменяться: изменяется 
самоанализ: самоанализе 
техника: техника техники 
считывать: считывающий считывали 
нецелевой: нецелевому нецелевого 
фотография: фотографиями фотографий 
костенков: Костенков 
соответствие: соответствие соответствия соответствии 
вращение: вращении вращения 
мультимедийный: мультимедийного 
команда: командой команды команду команд команде Команда команда 
где: где 
компанииреализовать: компанииРеализовать 
возвратно: возвратно 
делаться: делается Делается 
административный: Административная 
рядовой: рядовых 
причём: причем 
установкистранно: установкиСтранно 
уверенность: уверенностью 
репликация: репликация репликацией 
синтаксис: синтаксис синтаксисом 
блокировка: блокировки блокировок блокировками блокировке 
материя: материях 
меняться: менялись меняются меняется 
приглашение: приглашению 
владелец: владельца 
ограничить: ограничить 
магазин: магазина Магазин магазин магазинов 
вызов: вызовов вызова 
елехтроны: елехтроны 
балансировка: Балансировка балансировке балансировки балансировка Балансировке балансировкой балансировку Балансировкой 
удовлетворение: удовлетворении 
жизнь: жизнь жизни Жизнь 
недоступный: недоступны 
накопление: накопления 
представить: представила представленного представить представленных представлены 
теорема: теорему 
причудливый: причудливые 
демонстрировать: демонстрируют демонстрирует 
испытать: испытаем 
денежный: денежных 
разрешение: разрешения 
интервьюирование: интервьюирование 
край: краю краев 
инвестор: инвесторов 
верхний: верхнего Верхняя верхнем 
газета: газету 
эволюция: эволюции эволюция 
сеть: сети сетей сетью сеть сетями 
голосование: голосовании голосование голосования Голосование 
предъявляться: предъявляются 
пользоваться: пользовавшемуся пользовался пользуются пользоваться 
недостаток: недостатках недостатки 
пакет: пакетов пакеты пакет 
ноду: ноду 
совершить: совершить 
высокий: высокую высшую высокой высокий высокая 
вск: ВСК 
плавать: плавающей 
географический: географического географические 
причинный: Причинно причинно 
нейросетевой: нейросетевой 
неподдерживаемый: неподдерживаемых 
обучаться: обучается обучалась 
любопытный: любопытные 
идентификация: идентификацию идентификации 
перенаправление: перенаправление Перенаправление 
лог: Логи логов лог логи 
вкладка: вкладке вкладку 
обычный: обычных обычными обычным обычные 
призвать: призвана 
централизованнымсделайте: централизованнымСделайте 
принципиальный: принципиальным принципиальной 
пентестов: пентестов 
ещё: еще Еще 
балансировать: балансируемого балансировать 
зависеть: зависят зависящей зависит 
удаться: удалось 
подсеть: подсети 
капустин: Капустин 
прогноз: прогноза прогноз прогнозы 
разница: разница Разница разницы 
расположение: расположения 
автомобиль: автомобилями 
накопитель: накопитель накопителя 
однотипный: однотипных 
зарегистрироваться: Зарегистрироваться Зарегистрируйтесь 
беляев: Беляева 
вы: вас Вы вами вам Вас вы 
удобность: удобность 
стрекалов: Стрекалов 
деревянный: деревянное деревянном 
отзыв: отзывы отзыв отзывам 
улучшение: улучшении Улучшение улучшения 
человеческий: человеческого 
информировать: информирует 
заметно: заметно 
списаться: Списавшись 
разворачиваться: разворачивается 
движок: движках 
мораль: морали 
рекомендация: рекомендациями рекомендациям рекомендации 
июль: июля 
давно: давно 
звучать: звучит Звучит 
гигантский: гигантской гигантская 
лицо: лицо лиц лицами 
установкапользователям: УстановкаПользователям 
оценивать: оценивали оценивать 
предыдущий: предыдущий предыдущего предыдущим 
микропроцессорный: микропроцессорной 
автотеста: автотеста 
монетизация: Монетизация монетизации 
кастомных: кастомных 
кастомизаций: кастомизаций 
доработка: доработка 
документация: документацию документация документации 
отсутствие: отсутствие Отсутствие отсутствия 
внимательно: внимательно 
прочность: прочности 
про: про 
последовательность: последовательности последовательность последовательностью 
моделировать: моделирует 
кликнуть: кликнуть 
сейчас: Сейчас сейчас 
природа: природу 
эллиптический: эллиптическими 
определённо: определенно 
иконка: иконки иконок 
снижать: снижает 
недостаточный: недостаточный 
свобода: свободу свободы свободой свободе свобода 
основной: Основные основные Основной основной 
вихретоковые: вихретоковые 
генеративный: генеративный 
частный: частных частным 
типизирования: типизирования 
проявляться: проявляется 
означать: означает 
реализация: реализация реализации реализацией 
начальный: начальный Начальный 
функционирование: функционирование 
являться: является являющийся являются 
же: же 
статистический: статистического статистический статистические 
таймаут: таймаутам 
импорт: импорт импорта Импорт 
операнд: операнд 
сканированиена: СканированиеНа 
вовлечённость: вовлеченности 
закируллин: Закируллин 
хранить: хранить хранит хранимые 
заморозить: заморозим 
превращать: превращает 
положительный: положительный положительных 
видеосвязи: видеосвязи 
таск: Таск таск 
это: этом этого Это этим это 
разобраться: разберемся разобраться 
остаться: останется 
можно: Можно можно 
фотошоп: фотошопа фотошопу 
утверждение: Утверждение 
подгонять: подгонять 
открытие: открытий 
пользовательский: Пользовательский пользовательского пользовательский пользовательских 
копирайтеров: копирайтеров 
обозначить: обозначены обозначен 
надеяться: Надеюсь надеюсь 
фрилансер: фрилансер 
после: После ПОСЛЕ после 
включая: включая 
вариант: вариантами варианты вариантов вариант 
отобразиться: отобразится 
анимация: анимации 
казаться: кажется Кажется 
орбита: орбитами 
сохранить: сохранить сохранены Сохраните 
координировать: координировать 
сбертех: Сбертех 
стекло: стекло 
колонка: колонок колонки 
уравновешивать: уравновешивающих уравновешивают уравновешивающие 
плагин: плагине плагинов плагины плагина плагин 
тестовый: тестовой Тестовая 
включение: включение 
мешать: мешает 
невозможный: невозможна невозможной 
данные: данным данных данными 
зонов: Зонов 
стержень: стержень 
десяток: десятков 
прилагать: прилагает 
превосходный: превосходный 
секунда: секунд 
уже: уже 
метод: методов методами метод метода Метод методах методы методом 
оператор: Оператор операторов оператор оператора операторах операторами 
забыть: забыли забудьте забыть 
пул: пул пулах 
дорого: дорого 
прочитать: прочитает прочитал 
расти: расти растут 
диапазон: диапазоне 
приводить: приводить приводит приводят приводим 
окно: окно окне 
удерживаться: удерживается 
сообщение: сообщение сообщений сообщения сообщениями 
госполь: Госполь 
образ: образ образом 
симптом: симптомов 
функционал: функционала функционалом функционал 
ограничение: ограничений ограничения ограничениях 
цикл: циклов цикл цикла 
игра: игр игра Игры игры 
загрузить: загрузить загружены Загрузить 
важный: важных важный важному важная важную важными важные 
цм: ЦМ 
применение: применение применения применении Применение 
намного: намного 
гайка: гайки 
превращаться: превращается превращаться 
марков: Маркова 
корпорация: корпорации 
электрический: электрические электрических 
шип: шип 
итерация: Итерация 
рекомендоваться: рекомендуется 
чудо: чуда 
выиграть: выиграла 
задавать: задавать задают 
переключаться: переключаться 
либо: либо 
обида: обиду обид 
папка: папку папкой 
стучаться: стучится 
процесс: процесса процессом Процесс процессов процессах процессе процессу процессы процесс 
арифметический: арифметических 
ба: БА 
мощный: мощные мощными мощный 
загрзить: загрзить 
гелиоцентрический: гелиоцентрической 
тариф: тарифу 
найти: найти нашел найди 
строиться: строится 
юзкейсом: юзкейсом 
бесплатный: Бесплатный бесплатном бесплатной бесплатная бесплатным бесплатный бесплатных Бесплатная 
компенсировать: компенсируют компенсировать Компенсирующие компенсирующий компенсирующих 
толщина: толщина 
иной: иные иным 
повышенный: Повышенная повышенное Повышенный 
обученияроме: обученияроме 
первоочередной: первоочередных 
вперёд: вперед 
маршрутизатор: маршрутизаторов 
расставаться: расставаться 
программированиюизучение: программированиюизучение 
онтико: Онтико 
обновить: обновленные обновить обновили Обновить 
бесплатно: бесплатно 
суммарный: суммарная 
геометрический: геометрическую геометрическим 
бунин: Бунина 
программа: программ Программа программы программа 
инерция: инерции 
нормативный: нормативных 
целевой: целевые целевому целевого 
деактивироваться: деактивируются 
кникнув: Кникнув 
подходить: подходит 
равновесие: равновесия 
завершаться: завершается 
заново: заново 
развёртывание: Развертывание развертывания 
в: Во во 
счёт: счет счете 
пополнить: пополнит пополнен 
интерес: интересов интересы интересам 
аутсорсинг: аутсорсинг 
фабрика: фабрики 
лошадь: лошади лошадь 
наладить: наладить 
мать: Мать 
размещаться: размещаются 
отмена: отмену 
спецслужба: спецслужб 
евгений: Евгений Евгения 
восстановиться: восстановится 
состоять: состоящих Состоит состоять состоят состоит 
отсутствовать: отсутствует 
дисбаланс: дисбаланс дисбаланса дисбалансом дисбалансе 
округляться: округляется 
играть: играют играть играет 
навык: навыки навыков 
бог: Бог 
рисунок: рисунок рисунке 
угловой: угловой 
предоставлять: предоставлять предоставляет 
гидронасос: гидронасосов 
удовлетворяться: удовлетворяется 
обязательно: обязательно Обязательно 
вещь: Вещь вещей 
сколько: Сколько сколько 
ротра: ротра 
правда: правда Правда 
сэмпл: сэмпл 
сделка: сделки 
прошлое: прошлого 
приблизительно: приблизительно 
интеллектбайесовские: интеллектбайесовские 
безусловно: Безусловно 
лежать: лежат лежит 
обученный: обученного 
настоящий: настоящее настоящему 
непосредственно: непосредственно 
кумулятивный: кумулятивный 
реагирование: реагирования 
указанный: указанного указанных указанные Указанный Указанные 
мочь: можете Может могли могу можем может мог могут 
вложить: вложенных 
задерживаться: задерживаются 
чувствительность: чувствительности чувствительность 
слово: словах слову словами слова слово слов 
преимущество: преимуществах преимуществ Преимущество Преимущества преимущества преимуществом 
сходство: Сходства 
богдан: Богдан 
маркетинг: маркетинга 
акт: актах 
камень: камнем Камень 
упоминать: упоминает упоминали 
менеджер: менеджерами менеджеры менеджерам менеджеров 
безопасность: безопасность безопасности Безопасность 
болтовый: болтовые 
искать: ищите ищет искать 
данный: Данный данное данного данном данный 
таблицупри: таблицуПри 
документирование: документирования 
заниматься: занимался занимается занимаются заниматься 
взаимодействовать: взаимодействовать взаимодействуют взаимодействует 
упростить: упростить 
форма: форме формы форма форму 
отбиться: отбиться 
модерировать: модерировать 
солнце: Солнце 
вниздинамический: внизДинамический 
прекрасный: прекрасный 
ярый: ярых 
из: Из из 
усреднить: усредненную 
залискусственный: залИскусственный 
типизировать: Типизированный 
затянутый: затянуты 
доказывать: доказывал 
предположить: предположил 
следовать: Следует следовать следует следуйте 
изучение: изучении изучению изучение изучения 
незначительный: незначительном 
болтливый: Болтливый болтливый 
воспитать: воспитать 
механика: механики 
дизайндизайнсофт: дизайнДизайнСофт 
магнитный: магнитных 
железо: железо железа 
выявление: выявления выявлении 
тормознуть: тормознуто 
приблизиться: приблизилась 
позиция: позиции позиций 
чтиво: чтиво 
хорошо: хорошо 
допечатный: Допечатная 
флаг: флагом флаг 
обслуживать: обслуживать 
сергеенко: Сергеенко 
интернет: Интернету Интернета Интернет интернет Интернете 
азия: Азии 
перенос: перенос 
циклический: циклическая циклической 
ограниченный: ограниченное 
кат: кат 
нетология: Нетология 
руководитель: Руководитель руководителей 
стендабалансировочный: стендаБалансировочный 
хранение: хранения хранение Хранение 
непрерывный: непрерывные непрерывных непрерывный непрерывного 
достаточный: достаточную достаточное 
останавливать: останавливать 
август: августа 
отклонить: отклоненным 
банальный: банальных банальной 
нанимать: нанимать 
попытка: попытке попытки попыткам 
технологический: технологических технологический технологическое 
потенциальный: потенциальными потенциальных потенциальной 
шаблон: шаблону шаблона шаблон 
так: Так так 
крит: Криты 
кастомизировать: кастомизировать 
ножницы: ножницы 
запланировать: запланированное 
ряд: ряда ряд ряде ряды 
анатолий: Анатолий 
никто: никто 
попробовать: попробовали попробуем попробуй 
тень: тенями 
виток: витков 
множественный: множественная 
проверять: проверять 
варит: варита 
панель: панели 
масштаб: масштабов 
совладелец: совладельцев 
видюха: видюха 
дело: дело деле делом дела 
откуда: Откуда откуда 
восстанавливаться: восстанавливаться восстанавливается 
маленький: маленький меньше поменьше 
воспринимать: воспринимающая 
наделить: наделить наделила 
бенчмарк: бенчмарк 
навигация: навигации 
вывод: вывода вывод выводе выводы 
комбинировать: комбинировать 
учесть: учтены учли 
малое: малым 
окончить: окончил 
розничный: Розничная 
фильтровать: фильтровать 
прийтись: пришлось придется 
туда: туда Туда 
преимущественно: преимущественно 
открыть: открыть Открыть 
ужасно: ужасно 
превосходить: превосходит 
ничто: ничем 
обратить: обратить Обратите 
квантизуемого: квантизуемого 
оплата: оплаты 
высокопроизводительный: высокопроизводительных 
хабре: хабре Хабре 
сбером: Сбером 
журналист: журналисты 
пас: паса 
свердловский: Свердловская 
деформация: деформации деформацией деформация Деформация деформациях Деформацией 
раздел: разделы раздел Раздел разделами разделе 
обычно: Обычно обычно 
ожидаться: ожидается 
эвристический: эвристические 
существенный: существенными 
карьера: карьеры карьеру Карьера 
аскон: АСКОН 
воздействие: воздействия воздействие 
отчёт: отчеты отчет отчетов 
молодой: молоды 
смонтировать: смонтировать 
автотестовчто: автотестовЧто 
рада: рады 
картинка: картинки Картинка 
редкий: редкого Реже 
акселерометр: акселерометры 
виброскорости: виброскорости 
страна: стран страны 
осуществлять: осуществлять 
подробный: подробную Подробнее подробнее подробного подробным подробных подробный подробны 
горизонтальный: горизонтальном 
заносить: заносить 
ниже: Ниже ниже 
ефименко: Ефименко 
уделять: уделять уделяя 
взяться: взялся 
асимметричный: асимметричных асимметричный 
всплеск: всплеск Всплески 
цапфа: цапф Цапфа цапфа 
вулкан: Вулкан 
роутер: роутера роутер 
игровой: игровые игровых 
поиск: Поиск поиске поисках поиска поиск 
методология: методологии методологий методология Методология 
проверка: проверки Проверка 
слияние: слияния 
тогда: Тогда тогда 
выбираться: выбираются 
разработать: разработанных разработанный разработали разработала разработанная разработать разработал 
усреднять: усредняют 
платный: платные 
разнообразный: разнообразных разнообразные 
расходный: расходных 
сохранение: сохранением сохранения 
практически: практически 
явление: явление 
адаптивность: адаптивность 
саморазвитие: саморазвитие 
лейкин: Лейкин 
патентоваться: патентуются 
изолироваться: изолируются изолируется 
рассматривать: рассматриваем рассматривать рассматривает рассматриваемые 
виджет: виджет 
зафиксировать: зафиксировать 
взять: взять взяли возьмем 
выпустить: выпущен выпустил 
предсказуемый: предсказуемо 
взнос: взноса 
исключение: исключение исключения 
голос: голосов голоса 
билет: билетов 
отладка: отладка 
март: марта марте 
движение: движения 
только: Только только 
пиар: пиара пиар 
поставить: поставить 
пассажир: пассажирам пассажирами пассажиров 
упражнение: упражнением 
уметь: умеет уметь 
пост: пост посте поста 
тренировочный: тренировочного тренировочный тренировочных 
особенный: особенных 
оправдывать: оправдывают 
вызывать: вызывают вызывали вызываемых вызывает 
пассивный: пассивное Пассивное пассивного 
пустой: пустого 
запатентовать: запатентовал запатентовали 
поступление: поступлении 
опытный: Опытные 
внесение: внесение 
детальный: детальному 
немаловажный: немаловажно 
воля: воли 
подписать: Подписан Подписана 
наделать: наделал 
манипулировать: манипулировали 
защищать: защищаем 
токеном: токеном 
температура: температуры температура температуру 
податливый: податливыми податливые 
насчитывать: насчитывает 
кастомизации: кастомизации 
никуда: никуда 
радость: радостью 
превосходство: превосходство 
смешно: смешно 
моментный: моментном моментным моментный 
недопустимо: недопустимо 
обеспечивать: обеспечивать обеспечивая Обеспечиваем обеспечивают обеспечивает 
филиал: филиалов 
проводиться: проводится 
плиз: плиз 
спрашивать: спрашивает спрашивать спрашивая 
творить: творить 
красный: красным 
ускорить: ускорить 
роторовважно: роторовВажно 
клиентский: клиентских 
образование: образование 
обнаружение: обнаружения обнаружением 
опасение: опасение 
линейно: линейно 
дискомфорт: дискомфорта 
сбыт: сбыт сбыта 
несимметричность: несимметричностью несимметричности 
крон: крону 
торговля: торговля торговли 
неважно: неважно 
тестирование: Тестирование тестирования тестировании тестирование 
понятно: Понятно понятно 
бесполезный: бесполезны бесполезный 
колебание: колебаниями колебаний колебания 
городской: городской 
вхождение: вхождения вхождение 
переменный: переменные переменным переменной переменных 
инснейросетинейросетевое: инснейросетинейросетевое 
обтравочные: обтравочные 
детализация: детализацию 
определить: определит определить Определить определен определены 
поднимать: поднимать 
обсуждаться: обсуждаться 
самостоятельно: самостоятельно 
хранениясуть: храненияСуть 
научить: научить 
развернуть: развернуть развернуты развернули 
никакой: никакой никакая 
предложение: предложения 
однако: однако Однако 
частность: частности 
спросить: спросить 
тем: Тем тем 
участие: Участие участие 
квалификация: квалификации 
порядок: порядком порядок 
немногий: немногими 
отличие: отличие Отличие 
решениекороче: РешениеКороче 
предобученная: предобученная 
декабрь: декабря 
чуточку: чуточку 
станок: станка станков станках станки 
импортировать: импортируемого импортирую 
промисов: промисов 
окологосударственных: окологосударственных 
безопасностьсистемное: безопасностьСистемное 
сложиться: сложились 
реально: реально 
метафорический: метафорических 
точный: точный Точное точного точны 
государственный: государственных 
перехват: перехвата 
приступать: приступать 
исчисление: исчисления исчисление 
аналогично: аналогично 
избежание: избежание 
раскол: раскол 
при: При при 
именно: Именно именно 
селектор: селектора 
капитальный: капитальных капитальные 
поэтому: поэтому Поэтому 
беседа: беседы бесед 
ава: Ав 
холдинг: холдинг 
артефакт: Артефакты артефактов артефакты артефактами 
сверление: сверлением 
суть: сути 
ориентировать: ориентированный ориентированной 
испания: Испания 
устояться: устоявшимися устоявшиеся 
журнал: журнала 
идеальный: идеального идеален идеальным 
восторг: восторг 
полиномиальный: полиномиального 
таблица: таблицы таблицу таблицами таблице 
удовлетворять: удовлетворяет 
шум: шума 
сформулировать: сформулированы 
занимательный: Занимательные 
промиса: промиса 
стилидаже: стилиДаже 
приклеиваться: приклеивается 
купить: куплены 
отправка: отправки Отправка 
но: Но но НО 
институт: Института 
увеличиться: увеличится увеличившись 
переходить: переходит 
масштабирование: масштабирования масштабирование 
куренкова: Куренкова 
некорректно: некорректно 
координата: координаты 
мегафон: МегаФон 
старт: старте старту 
интерсепторов: интерсепторов 
вмешательство: вмешательства вмешательство вмешательстве 
баланс: баланс 
новость: новостей новости Новости 
нтц: НТЦ 
зарезонансном: зарезонансном 
энтузиаст: энтузиаст 
фомин: Фомин 
коллизия: коллизий 
расчётный: расчетные 
измениться: измениться изменятся 
администрирование: Администрирование администрирование 
уверенный: уверен 
аналогия: аналогией 
калачева: Калачева 
егорро: Егорро 
обрабатывать: обрабатывать обрабатываемых 
товар: товар товара 
финтех: финтех Финтех ФинТех 
держаться: держится 
подробно: подробно Подробно 
не: Не не 
распределять: Распределяя 
аналитикив: аналитикиВ 
почти: почти 
продать: проданных 
хотеть: хотим хочет хотят хотите хотели хотел 
объяснять: объясняет 
апрель: апреля 
истечение: истечению 
документ: документом документ документы 
вместо: Вместо вместо 
масштабируемость: масштабируемости 
сопоставить: сопоставить 
комбинация: комбинацию 
эл: эл 
распределение: распределения 
локально: локально 
ощущение: ощущение 
пропс: пропсов пропсы 
свидетельство: свидетельством 
помочь: помогут помогли помочь поможет 
вычислитель: вычислитель 
идеально: идеально 
возрасти: возросло 
лазер: лазера 
осмысление: осмыслению 
мониторинг: мониторинга Мониторинги мониторинг 
вентилятор: вентиляторов вентилятор Вентиляторы 
замена: замены замена 
несоосность: несоосностями несоосность 
аналитика: аналитика Аналитика 
борьба: борьба борьбу борьбе борьбы 
источник: источниками источников 
драйвер: драйверов драйвера 
агрегировать: агрегировать 
отключение: отключения 
бывать: бывает 
непрозрачный: непрозрачный 
правило: правил правилам правила правилами правило 
джавовый: джавовый 
техподдержка: техподдержкой техподдержку 
оба: Оба обе Обе 
бакете: бакете 
инфосистемы: Инфосистемы 
отказоустойчивый: отказоустойчивым отказоустойчивую отказоустойчивой 
перл: Перлом Перл Перлу Перла 
несвязанный: несвязанных 
идти: идем идет 
повышаться: Повышается 
тонкость: тонкость 
недостаточно: недостаточно 
дорезонансные: дорезонансные 
достигнуть: достигнут достичь 
прорыв: прорывах 
базовый: базовые базовых 
обратный: обратное обратного обратная 
отсюда: Отсюда 
маркетплейс: Маркетплейс 
посоветовать: посоветовала 
децентрализация: децентрализацию 
параллелизм: параллелизму 
поступать: поступающих поступали поступающие 
всегда: Всегда всегда 
основа: основе Основы основ основой Основа 
обрезать: обрезать 
достаточно: достаточно Достаточно 
аномалия: аномалий 
роман: Роман 
пояснить: Поясните пояснила 
поведение: поведения поведение 
выстраивать: выстраивает 
плохо: плохо Плохо 
протокол: протоколов 
вести: вести 
футбол: футбол 
вообще: вообще 
точность: точности Точность точность 
слышать: слышал 
столкнуться: столкнулись 
скриншот: скриншоте скриншотов 
табличка: табличке 
достижение: достижение достижения достижениями достижением 
видео: Видео видео 
миллиард: миллиарда миллиардов 
тщательно: тщательно 
кость: кости 
трехуровневое: трехуровневое 
опять: опять Опять 
функциисреди: функцииСреди 
много: много 
уходить: уходить 
я: Меня мне меня 
неправильный: неправильного 
значимый: значимым Значимой 
вне: вне 
силовой: силового 
относиться: относятся относимся 
рука: руками руки 
президент: президента 
триандафилиди: Триандафилиди 
осевой: осевом осевые 
правильность: Правильность 
бумага: бумага 
запрещать: запрещал 
круговой: круговой 
платформенный: платформенной 
критик: критиков 
подходящий: подходящих 
оптимизировать: оптимизировать 
сканить: сканить 
квадрат: квадрату 
регулирование: регулирования 
нет: Нет нет 
случайный: случайным 
топология: топологии топологий топология 
редактированиес: РедактированиеС 
данныххранилища: данныхХранилища 
фидбэку: фидбэку 
качение: качения 
этап: этапе этап этапах 
происходить: происходящего происходить происходило происходит 
том: Тома тома томов 
ноябрь: ноября 
байтовый: байтовых 
занятый: занят 
встречать: встречал 
тело: теле тело 
упасть: упала 
выше: выше 
оперировать: оперировать 
общаться: общаться общаетесь 
задание: задание 
задействовать: задействовать 
представление: представления представление 
неудобный: неудобная 
корпораты: корпораты 
регламентировать: регламентирующим 
оригинал: оригинала Оригинал 
упираться: упираешься 
сказать: сказал сказано сказать 
сканированияудля: сканированияУДля 
входить: входят входить входит 
встречаться: встречался 
объектный: объектное объектного объектных объектные 
предлагаться: предлагается 
выполниться: выполнится выполнятся 
обращать: обращать 
полупрозрачный: полупрозрачная 
радиус: радиус 
собственность: собственности собственностью 
даваться: даваться 
вибросигнала: вибросигнала 
разрабатываться: разрабатывался 
видимость: видимости 
резервный: резервных резервные 
служить: служить служит 
бессмысленно: бессмысленно 
главное: главное Главное 
эпоха: эпох эпохи эпохе 
объединить: объединенных объединившая 
хекслет: Хекслет 
наедине: наедине 
кассовый: кассовые 
обл: обл 
доля: долю Доля доля 
сохраняться: сохраняется 
гик: гиков 
связипричинаследствиеасимметрияматематикаязык: связипричинаследствиеасимметрияматематикаязык 
экранирование: экранирование 
легковесность: легковесность 
звук: звук 
колебний: колебний 
нестрогий: нестрогой 
тонирование: Тонирование 
фильтрация: Фильтрация 
обучениеискусственный: обучениеИскусственный 
неограниченный: неограниченное 
полимер: полимеры 
файл: файлов файла файлами файле Файл файлам файл файлы 
тоже: Тоже тоже 
полноэкранный: полноэкранный 
никак: никак 
активация: активация 
гораздо: гораздо 
минусанули: минусанули 
собирать: собирать собирают Собираем собираем 
геометрия: геометрии 
уменьшаться: уменьшается 
подозрение: подозрение 
старый: старую старая 
заметка: Заметки заметку 
богатый: богатой 
ботанайдите: ботаНайдите 
запустить: запущена запустила запущено запустить запущен Запустите 
наука: науке наук наука 
проводить: проводит проводить 
стоить: стоило Стоит стоить стоит 
кодирование: кодирования 
сканированиеактивное: сканированиеАктивное 
искажение: Искажение 
фантастика: фантастика 
польза: пользы 
конвейере: конвейереы 
соединение: соединение соединения 
батчинг: Батчинг 
эквивалент: эквивалентом 
прогнозирование: прогнозирование прогнозирования 
обязанность: обязанность 
рубеж: рубежа 
добиться: добиться 
общение: общению общение Общение общения 
зал: зал 
литерал: литерал литералы литералов 
контроль: контроль контроля 
рассказать: рассказали расскажем 
документацияисходный: ДокументацияИсходный 
массовый: массовым 
проворный: проворная 
равенство: равенство 
дообучение: дообучении дообучения 
индексный: индексных Индексный индексные 
воспользоваться: воспользуемся 
пропорциональный: пропорциональна пропорциональны 
отказывать: отказывать 
замечать: замечать 
далёкий: дальше 
дообученных: дообученных 
оплачивать: оплачиваемого 
квантизованных: квантизованных 
возможный: возможным возможными возможные Возможна возможных возможен 
здоровье: Здоровье 
очевидный: Очевидно очевидна очевидно 
настольный: настольных 
длина: длины длине длиной длина 
контекст: контексте контексту контекст 
сменить: сменить 
наблюдаться: наблюдались 
ужесточение: ужесточением ужесточение 
бесконечный: бесконечным 
сэмпла: сэмпла 
популяция: популяции популяцию 
функциональность: функциональности функциональность 
модальный: модальное 
громкий: громкое 
трафикапосле: трафикаПосле 
следить: следил следить 
лихорадка: лихорадку 
парсит: парсит 
рядом: рядом 
неустанно: неустанно 
конфигурирование: конфигурирования 
сплит: сплит 
призрак: призраков 
исходить: исходя 
ругаться: ругается 
уравнение: уравнениях 
программироваться: программироваться 
рамка: рамках 
блогер: блогеры 
кошка: кошка кошки 
прекрасно: прекрасно 
многословность: многословности 
аналогичный: аналогичными аналогичные 
заполнить: заполнить 
др: др 
печать: печати 
разрушение: разрушению 
отклоняться: отклоняется Отклоняется 
колмогоров: Колмогорова 
эффективность: эффективности эффективность 
интуитивно: интуитивно 
практикум: Практикум 
валерий: Валерия Валерий 
сотрудник: сотрудников Сотрудники сотрудник сотрудникам 
поверхность: поверхностями поверхности 
нидерланды: Нидерландах 
обновиться: обновятся обновиться 
адрес: адреса адрес адресом 
совместимостиа: совместимостиА 
актив: Актив активами 
перспектива: перспективы 
выступать: выступают 
футбольный: футбольная 
западный: западные западных 
глобально: глобально 
верхас: Верхас 
заявление: заявление заявлением Заявление заявлению 
многомодульный: многомодульных 
ненависть: ненависть 
энергетический: Энергетического 
эффективно: эффективно 
директор: директор директором 
наплавка: наплавкой 
хранилищеобычно: хранилищеОбычно 
поделиться: поделитесь 
снисходительный: снисходительна 
кэшировать: кэшировать 
о: Об об 
воображать: воображаемый 
александр: Александр 
носить: носит носили 
удача: Удачи 
записывать: записывать 
передаваться: передаваться передаются передается 
выжигание: выжиганием 
размытие: размытия 
пропорционально: пропорционально 
абстракция: абстракции 
рейс: рейсы рейса 
приятный: приятнее 
точить: точь 
обеспечить: обеспечить 
запуск: запуска запуск Запуск 
вводиться: вводится 
некруглости: некруглости 
конечный: конечном конечный 
семейство: семейства 
бухгалтерия: бухгалтерии 
читаемость: читаемость читаемости 
обратно: обратно 
просвещение: Просвещенья 
валидировать: Валидировать 
чем: чем 
демпфирование: демпфирования 
гарантировать: гарантировано гарантирует гарантирован гарантировать 
рассматриваться: рассматриваются 
просмотреть: просмотрите 
обязать: обязан 
удалённый: Удаленная удаленного 
периферия: периферии 
столько: столько 
эмпирический: эмпирических 
чистый: чистой Чище 
счастие: счастью 
приципу: приципу 
алерты: алерты 
цент: центов 
немой: нем 
развить: развить 
лицензирование: лицензирование лицензирования 
говориться: говорилось 
вес: весов веса 
приватный: приватная приватными приватных приватную 
викторович: Викторовна 
предоставление: предоставления предоставлению 
изучать: изучать изучает 
накапливаться: накапливаются 
рефлексия: рефлексии 
вектор: вектор Вектор 
пусть: пусть 
влечь: влечет 
отклонение: отклонение отклонении 
чей: чьи 
дебаге: дебаге 
нажать: нажать нажмите 
сортировать: Сортировать 
сияние: сияние 
кстати: Кстати кстати 
видный: видны 
прогностический: прогностический 
реплика: реплик реплику репликами 
идентичный: идентичную идентичных 
ловко: ловко 
изобретаться: изобретаются 
критически: критически 
несимметричный: несимметричный 
флагманский: флагманского 
тестер: тестер 
тестировать: тестируемого 
изобретение: изобретения изобретение 
сомнение: сомнения 
ниша: нишу 
жёсткость: жесткостью жесткость жесткости Жесткость 
тз: ТЗ 
пока: Пока пока 
завинчивание: завинчиванием 
поворот: поворотом поворота 
заговорить: заговорили 
приоритетный: приоритетных 
непредсказуемый: непредсказуемого 
ежеминутно: ежеминутно 
рептилоид: Рептилоид 
совместимый: совместимое 
извлекать: извлекать 
требоваться: требуются требуется 
деталь: деталей 
ассоциативный: Ассоциативных ассоциативному ассоциативных 
стакан: Стакан 
дильдин: Дильдин 
виброперемещения: виброперемещения 
рф: РФ 
рассуждать: рассуждать рассуждали 
сперва: сперва 
мой: мой моих моя 
важность: важность 
указывать: указываем указывать 
изгиб: изгибом 
регламент: регламент 
парадокс: парадоксов 
профессионал: профессионала профессионал 
передать: передать 
модерация: модерации 
трекер: Трекер 
впечатлить: впечатлен впечатлены 
симметрия: симметрия симметрию 
статус: статус 
облегчать: облегчает 
делиться: делятся делитесь 
разворачивать: разворачивать 
некорректный: некорректное 
планирование: Планирование 
рисовать: рисовать 
упомянуть: упомянутый 
содержаться: содержащиеся содержащееся 
звено: звеном 
цензура: цензурой цензуры 
гибкость: гибкость 
норма: норма нормы нормами 
соотнести: соотнести 
долгий: дольше подольше 
единица: единицами единицы единиц 
агрегированный: агрегированные 
релиз: релиза релизах релизов релиз 
рейтинг: Рейтинг рейтинге рейтинга рейтингу 
вера: вера 
вероятный: вероятное 
там: там 
большой: побольше больше большом Больше велика большого большой 
ноутбук: ноутбуки 
нажатие: нажатия нажатии 
хамелеон: Хамелеоном Хамелеоне Хамелеон 
утилит: Утилит утилиты 
заместитель: заместителем 
потребление: потребления 
устанавливаться: устанавливается устанавливаются устанавливаться 
чемпион: чемпионом 
исследовать: исследуем исследовать Исследуем 
коллектив: коллектив 
читабельный: читабельным 
молния: Молния 
по: ПО По по 
объединять: объединяют 
услышить: услышить 
профессия: Профессия профессии профессий 
реестр: реестра реестр 
центр: центру центры 
скидка: Скидка скидку 
функциональный: функциональное функциональным функционального 
наличный: наличных 
пожелание: пожелания 
лаборатория: Лаборатория 
нулевой: нулевой нулевого 
голодный: голоден 
прототипный: Прототипно 
гречачин: Гречачин 
нормальный: нормальная нормальной 
вставать: встает 
разумный: разумным разумные 
мосбиржу: Мосбиржу 
слева: слева 
осведомлённость: осведомленности 
инфоцентр: Инфоцентры 
обнаруживать: обнаруживает 
час: часов час часа 
упругость: упругостью упругости 
пригодиться: пригодятся 
префикс: префикс Префикс 
хост: хосты хостов хостах 
следствие: следствиях 
случаем: случаем 
оборотный: оборотных 
проч: проч 
экономика: экономики 
селекция: селекции селекцию 
касаться: касающейся 
среднее: среднего 
привычный: привычны привычными 
сегодня: Сегодня сегодня 
разбирательство: разбирательство 
волшебный: Волшебная 
занесение: занесении 
история: История Истории истории 
голосовой: голосовой 
построение: построение построения 
субд: СУБД 
составлять: составляет 
подшипниковый: подшипниковых подшипниковые 
прогресс: прогресса 
объяснение: объяснение 
оптимизатор: оптимизатором оптимизатора оптимизатор 
выводиться: Выводится выводиться 
время: Время времени временем время 
уточнять: уточнять 
связываться: связывается 
размерность: размерности размерностью размерность 
необходимость: необходимости 
отразиться: отразиться 
видимо: видимо 
нарушить: нарушена 
зарезонансные: Зарезонансные зарезонансные 
ужель: ужель 
хозяйка: хозяйке 
спасибо: Спасибо 
политический: политической политический 
оригинальный: оригинальные оригинальной оригинальное 
двойной: двойном 
предсказывать: предсказывать 
здесь: Здесь здесь 
разделять: разделяете разделяющих разделять 
вспомогательный: вспомогательном 
нерешённый: нерешенные 
ну: Ну 
запрет: запретов 
премия: премию премии 
портал: портал 
готовить: готовить Готовит 
передаваемый: передаваемое 
данныхсозданиедля: данныхСозданиеДля 
стилизация: стилизации 
адекватный: адекватные 
зайти: зашел 
добавляться: добавляться 
эксклюзивный: эксклюзивному 
регистр: регистр 
голосовать: Голосуй 
сегодняшний: сегодняшнего 
квантизация: квантизации квантизация 
хитрый: хитрым 
электролиз: электролизом 
часто: часто 
сиренко: Сиренко 
разделитель: разделителей разделителем 
записейчтение: записейЧтение 
ковырин: Ковырин 
коротко: Коротко 
содержимое: содержимого содержимым 
райя: Райе 
кодовый: кодовой 
марковский: Марковские 
защита: защите защиты Защита защитой защиту 
хабы: Хабы 
зачастую: зачастую 
электромагнитный: Электромагнитные 
совершенно: совершенно 
инерционность: инерционности 
урок: уроке 
кластеризацияпри: КластеризацияПри 
ом: ом 
низко: низко 
май: мая 
логический: логического 
измененийпри: измененийПри 
субмодулей: субмодулей 
дополнительно: дополнительно Дополнительно 
отрывать: отрывать 
бакетаимя: бакетаИмя 
сопоставимый: сопоставимые 
единый: едином единой 
сетипричинно: сетипричинно 
дмитрий: Дмитрий 
сюда: Сюда сюда 
обнаружить: обнаружить 
южный: Южной 
держать: держать 
подойти: подойдет 
швейцарский: швейцарского 
под: Под под 
коннектор: коннекторов коннектор 
совокупность: совокупность 
привыкнуть: привыкнуть 
тигр: тигр 
выглядеть: выглядят выглядит 
память: памяти память памятью 
феликсович: Феликсович 
уменьшение: Уменьшение уменьшение уменьшения 
реакция: реакция 
юзер: юзера юзеры юзер Юзер 
усилиться: усилились 
массивный: массивного 
мошенник: мошенников 
район: районе 
больной: болен 
библиотечный: библиотечный 
потому: Потому потому 
заказывать: заказывайте 
изобретатель: Изобретатель изобретателя 
эргономист: Эргономист 
озарение: озарение 
кастомные: кастомные 
прежде: прежде 
превышать: превышать 
несущий: Несущие несущими 
овчинцев: Овчинцев 
присваивание: присваивания 
согласно: согласно 
состав: состав 
отечественный: отечественного 
дорожный: дорожных 
через: через Через 
сразу: сразу Сразу 
крайний: крайней крайних 
препятствовать: препятствующий препятствует 
значит: значит 
перехватить: перехвачены 
жарков: Жаркова 
возвращаться: возвращается 
варшавский: Варшавский 
справиться: справиться 
появляться: появляется 
пара: пара парой 
председатель: председателя 
максимальный: максимальной 
переводить: переводить 
цитата: цитаты 
учёный: ученый 
карма: Карма 
юридический: юридическими 
индуктированный: индуктированный 
подача: Подача 
клише: клише 
добавиться: добавятся добавиться 
инфрастуктура: инфрастуктуры 
ответственность: ответственность ответственности 
бросить: бросивших бросив 
шейка: шеек 
потребоваться: потребоваться потребуется 
грм: ГРМ 
доступность: Доступность 
банкомат: банкоматы 
преподаватель: преподаватель 
подписчик: Подписчики 
основать: основан основано 
произвести: произвести 
наталья: Наталья 
теггированые: Теггированые 
иностранный: иностранные иностранных 
подытожить: подытожить 
тусовались: тусовались 
сконфигурировать: Сконфигурировав сконфигурированный 
безопасностьюдалеко: безопасностьюДалеко 
токенов: токенов 
похожий: Похожие похож похожи похожих похожа 
минимум: минимум Минимум 
алгебра: алгебры 
приводиться: приводится 
приближаться: приближается 
избавлять: избавляет 
скопировать: скопировать Скопировать 
удивляться: удивляются 
запятая: запятой 
нагрузочный: нагрузочным 
взгляд: взгляд 
назад: назад Назад 
существующий: существующему 
отобразить: отображена 
дипломный: дипломные 
подразумеваться: подразумеваются 
автоматически: автоматически Автоматически 
относительный: относительной 
встреча: встречи 
рендеринг: рендеринг 
чатадля: чатаДля 
руководить: руководил 
велосипед: велосипед 
организовать: организовать организовано Организовать 
удобный: удобное удобный удобных 
алекс: Алекс 
раздумье: раздумья 
произвольный: произвольных произвольный произвольной 
отображать: отображать 
входящий: входящее 
подвижный: подвижные подвижными 
особенность: особенности особенностями 
подписаться: подписавшись 
сидеть: сидят 
исповедовать: исповедуют 
раскрыться: раскроется 
вышеперечисленный: вышеперечисленное 
гаджет: Гаджеты 
радуга: Радуга 
естественный: естественные 
переехать: переехал 
значок: Значки 
статистика: статистику статистике статистики 
нод: нод 
опор: опорами 
наконец: Наконец 
лампа: ламп лампу 
паддинг: паддинг 
лёгкость: легкостью 
синтаксический: синтаксической 
волнистость: волнистости 
везде: везде 
посредством: посредством 
многий: многим многих 
привлекать: привлекает 
опциональный: опциональной 
специальный: специальных специальные 
софт: софта Софт 
ложноположительных: ложноположительных 
студент: студенты 
излагать: излагает 
подготовка: Подготовка 
далеко: далеко 
подвергаться: подвергалось 
воспроизводить: воспроизводит 
меню: Меню меню 
дорезнансного: дорезнансного 
пасовать: пасовать 
предполагаться: предполагается 
подпружиненный: подпружиненной 
напрямую: напрямую 
экономный: экономный 
великобритания: Великобритании 
немного: немного Немного 
подкласс: подклассов 
выбор: выбор выбором Выбор выбора 
любимый: любимый 
финтеху: финтеху 
типизация: типизации 
минимизация: минимизации 
знак: знаков знак 
картыданный: картыДанный 
наглядно: наглядно 
иб: ИБ 
запечатлеть: запечатлел 
вирус: вирусы 
конечно: Конечно конечно 
потерять: потеряла потерять 
помешать: помешать 
краеугольный: краеугольным 
вред: вреда 
ос: ОС 
отменять: отменяет 
компилятор: компилятора 
аквисовские: аквисовские 
бакет: бакет 
экспортировать: экспортировать 
критерий: критериям Критерии критерии 
обстановка: обстановке 
мыслить: мыслить 
строчок: Строчков 
тесно: тесно 
фильтр: фильтры 
заявить: заявил 
эльдорадо: Эльдорадо 
рубль: рубль рублей 
сбер: Сбер 
ворох: ворох 
вчера: вчера 
закладка: Закладки закладки 
токенам: токенам 
райффайзенбанк: Райффайзенбанк 
пружина: пружин 
регламентироваться: регламентируется 
календарь: календаря календари 
согласиться: Согласитесь 
комментировать: Комментировать 
сын: сын 
благородный: благородного 
объединение: объединения 
выводить: Выводить 
операционный: операционные операционная 
далее: Далее далее 
сопрягать: сопрягаемых 
обладать: обладать 
ассоциация: Ассоциация Ассоциацией 
роспатент: Роспатента 
пучок: пучком 
сырой: сырой 
преднастроенного: преднастроенного 
визуальный: визуального визуальный 
прерывание: прерывания 
заключений: ЗаключениеВ 
переподключится: переподключится 
распознать: распознать 
нарушение: нарушению 
напротив: напротив 
управлять: управлять 
фактологии: фактологии 
продолжить: продолжить 
физически: физически 
актуальность: Актуальность актуальность 
макет: макеты 
зато: зато 
перекос: перекосами перекосом 
сканированиепассивное: сканированиеПассивное 
тинькофф: Тинькофф 
желать: желать 
консультация: консультацию консультаций 
администратор: администратора администратором администратор администраторам 
сборщик: сборщиком 
масштабный: масштабного масштабным 
динамика: динамике 
неуравновешенный: неуравновешенных неуравновешенная 
определённость: определенность 
обрести: обретут 
выражение: выражение выражения 
разобрать: разберем 
ранее: ранее Ранее 
формировать: формируемые 
переиспользуются: переиспользуются 
валентин: Валентин 
подтверждать: подтверждающему 
письмо: письма 
лопастный: лопастных 
медик: медиков 
пригласить: Пригласил Приглашен 
решать: решать решает решают решаем 
обсудить: обсудить 
трассировка: трассировкой 
без: Без без 
расположить: расположенный 
торговый: Торговой 
обещать: обещают 
твой: твоего 
умение: умение 
учебник: учебник 
резко: резко 
полагать: полагаете полагаем 
сообаржений: сообаржений 
россграм: Россграм 
товарный: товарных товарный 
древний: древние 
обстоять: обстоят 
неправильно: неправильно 
разум: разума 
программировать: программировать 
благодаря: Благодаря благодаря 
хакер: хакер 
прибегнуть: прибегнуть 
сетейна: сетейНа 
понижать: понижая 
сократиться: сократится 
ход: ходе ходом 
постулировать: постулировать 
центробанк: Центробанк 
комфортный: комфортной 
подробность: подробностей подробностью 
расширять: расширять 
многократный: многократным 
препятствие: препятствиями 
уточнение: Уточнение 
ссср: СССР 
системтестирование: системТестирование 
дефолтные: дефолтные 
нежелательный: нежелательного 
десять: десять 
резервирование: резервирование 
регулировать: регулировать 
выделяться: выделяется 
школа: школа Школа школу 
маршрутизация: маршрутизации 
ркн: РКН 
переоценить: переоценена 
стоимость: стоимость 
кибербезопасности: кибербезопасности 
входной: входные входной входного 
давление: давления 
сверкать: Сверкающая 
исправный: исправные 
устройствас: устройстваС 
спрятать: спрятано 
да: Да да 
ударный: ударного 
усилие: усилий усилия 
инициатива: инициативе Инициатива 
наполовину: наполовину 
поддержка: поддержка поддержку поддержки 
гипотеза: гипотезу 
событийалерты: событийалерты 
похоже: Похоже 
токены: токены 
датасета: датасета 
бы: бы 
накопиться: накопится 
поиметь: поимеем 
заключениетаким: ЗаключениеТаким 
риск: риски 
различить: различить 
шейк: шейка 
анастасия: Анастасия 
неприемлемый: неприемлемо 
необходимо: необходимо 
поправка: поправкам 
удалять: удалять 
оформить: оформить 
пк: ПК 
пол: пола пол 
потрясный: потрясен 
шайба: шайб 
продавать: продавая 
регулярно: регулярно 
раскручиваться: раскручиваются 
бенчмарка: бенчмарка 
графовым: графовым 
предстоять: предстоит 
редактирование: редактирования редактированием 
россельхозбанк: Россельхозбанк 
успешность: успешности 
вконтакте: ВКонтакте 
топ: топ ТОП Топ 
слушатель: слушатель 
любить: любят люблю 
критический: критическими критические 
патентный: патентный патентной 
кросплатформенность: кросплатформенность 
пополняться: пополняется 
брайт: Брайт 
обновлять: обновлять обновляет 
усложнять: усложняет 
предполагать: предполагает предполагают 
подключать: подключаемому подключать подключаемого 
латынь: латынью 
попов: Попов 
заняться: заняться занялся 
терпеть: терпит 
итог: итогу итоге 
узлеэто: узлеЭто 
научно: Научно 
слиться: слиться 
придумывать: придумывать 
сжатый: сжатая 
правительство: правительство 
плавный: плавной 
смещение: смещение 
подниматься: поднимается 
подготовить: подготовить 
старожил: Старожил 
логика: логика 
дообучить: дообучить 
списокпопулярные: списокпопулярные 
правильно: правильно 
оформлять: оформляет 
вместе: Вместе вместе 
производительный: производительный 
кодировать: кодируемых 
надёжно: надежно 
лично: Лично 
возбуждать: возбуждающей 
третий: третье третьей третий 
суперклассу: суперклассу 
методика: методика 
методический: Методические 
сократить: сокращенном 
верно: верно 
интервью: Интервью интервью 
цепочка: цепочку 
конкурент: конкурентов 
ловить: Ловим Ловите 
вполне: вполне Вполне 
корректироваться: корректируются 
данныхприложение: данныхПриложение 
читальный: Читальный 
математика: математике 
рукопожатие: рукопожатие 
откат: отката 
путешествие: путешествий 
демфирования: демфирования 
электропривод: электропривода 
хотелки: хотелки 
сколтех: Сколтех 
незнакомый: незнакомых 
ррс: РРС 
до: До до ДО 
настолько: настолько 
туториал: Туториал 
поскольку: Поскольку поскольку 
деньга: денег 
переезжать: переезжает 
модный: модное 
концептуальный: концептуальные 
вовремя: вовремя 
конструктивный: конструктивные 
доказать: доказано 
за: За за 
жаль: Жаль 
самописные: самописные 
работыитогя: работыИтогЯ 
замечательный: замечательной 
интерактивность: интерактивность 
инициализациилучше: инициализацииЛучше 
предупреждение: предупреждение 
подстрока: подстроки 
банковский: банковской 
существо: существ 
атлант: Атланты 
значительно: значительно 
сортировка: Сортировка сортировка 
предобработаны: предобработаны 
кнопочка: Кнопочка 
изменениянашей: измененияНашей 
прожить: прожить 
ознакомиться: ознакомиться 
предписывать: предписывают 
включать: включают включает включающих 
ни: ни Ни 
коммуникационный: коммуникационные 
помещать: помещать 
надстройка: надстройка 
затухать: затухающих 
англ: англ 
дообучать: дообучать 
приходить: приходить приходила приходит 
отображаться: отображалась 
предоставляться: предоставляется 
конец: конца конце 
япония: Японии 
ершовый: Ершова 
набирать: набирает 
екатеринбург: Екатеринбург 
бакетеявное: бакетеЯвное 
также: Также также 
градиент: градиент градиентам 
открывать: открывает 
инновационный: инновационных инновационные 
коммуникация: коммуникации 
квантизованным: квантизованным 
стильный: стильное 
вершина: вершина 
патентовать: Патентовали 
насколько: насколько Насколько 
предсказать: предсказать 
глава: Глава 
лидер: лидеров лидера 
бесконтактный: бесконтактных 
нарастать: нарастают 
встраиваться: встраивается 
даунтайма: даунтайма 
избранный: избранные 
странно: Странно 
снижение: Снижение 
строкедобавить: строкеДобавить 
пуск: пуск пусков пуске 
модернизация: модернизация 
анна: Анна 
опробовать: опробованных 
поздороваться: поздороваемся 
микроконтроллер: микроконтроллеров микроконтроллеры 
одноцветный: Одноцветный 
контент: контентом 
жить: живут 
обоснованный: обоснованные 
узкоспециализированы: узкоспециализированы 
сан: Сан 
монтаж: монтажа 
исо: ИСО 
регистрироваться: регистрируются 
предобученный: предобученный 
падение: падение 
грань: гранью 
переиспользовать: переиспользовать 
лишь: Лишь лишь 
спектр: спектру 
разделение: разделение 
уход: уходу 
валидация: валидации 
узлаимпорт: узлаИмпорт 
сетка: сетки 
процессор: процессорами процессоры 
уничтожить: уничтожен 
виброакселерометры: виброакселерометры 
определиться: определиться 
скрывать: скрывать 
наготове: наготове 
авиаперевозка: авиаперевозок 
зона: Зона 
обучениемы: обучениеМы 
тест: теста тест 
объявить: объявлены 
вводить: вводя 
мультиязычный: мультиязычный 
будущий: будущие 
процедура: процедуры 
заслать: зашли 
резонанс: Резонанс резонанса резонансов 
комплектующие: комплектующие 
командный: командной 
заставить: заставить 
репозиториясклонируйте: репозиторияСклонируйте 
фитнес: Фитнес 
ориентироваться: ориентироваться 
правовой: правового 
невозможность: невозможности 
терять: теряем 
публично: публично 
ггц: ГГц 
корявый: корявый 
ведь: ведь 
профиль: Профиль профилей 
уэбб: Уэбб 
разнести: разнесенных 
предотвращение: предотвращения 
сбалансировать: сбалансировав 
станкикак: станкиКак 
круто: круто 
нло: НЛО 
побуждать: побуждает 
акцент: акцентом 
крутой: крутой 
слетать: слетает 
социальный: Социальные 
поддерживаться: поддерживается 
байт: байт 
выключение: выключении 
павел: Павел 
последовательно: последовательно 
плоскостяхна: плоскостяхНа 
предусматриваться: предусматривается 
предсказание: предсказаний предсказания 
контакт: контакты 
освоение: освоении 
патентонлайн: ПатентОнлайн 
поколение: поколение 
космос: космос 
единственный: единственными Единственный 
два: двух две двумя два 
период: периода 
приходиться: приходится приходилось 
улица: улице 
плечо: плечо 
суперкласса: суперкласса 
пикселизации: пикселизации 
статика: статике 
геть: гейте 
перпендикулярно: перпендикулярно 
хромакей: Хромакей 
поздно: поздно 
набор: набором набор наборе 
коснуться: коснемся 
архитектор: архитектор архитекторам 
формальный: формальный 
настроить: настроить настроено 
зарезервированный: зарезервированных 
потолок: потолок 
способный: способен способных способны 
айсберг: айсберга 
общество: общества 
подстраиваться: подстраиваясь 
посредственный: посредственную 
стор: стор 
конкурентоспособность: конкурентоспособность 
неоплаченный: неоплаченную 
публичный: публичным 
выгрузка: выгрузку 
начисление: начисления 
оборот: оборотов 
настоятельно: настоятельно 
каталог: каталоге каталог каталогов 
жизненный: жизненного 
реквестов: реквестов 
проверить: проверьте проверить Проверьте 
перечислить: перечислены 
улучшить: улучшить 
аэропорт: аэропортами 
салуев: Салуев 
системуправление: системУправление 
телеграма: Телеграма 
присвоить: присвоит 
беговой: беговых 
дата: Дата 
домен: домен 
обучать: обучать обучаемых 
сочетание: сочетание сочетании 
отметчик: отметчик 
желание: желания желание желании желаниям 
русский: русской 
утверждать: утверждает 
качественный: качественная качественной 
удаляться: удаляться 
интересно: Интересно интересно 
придумать: придумал 
дисковый: дисковых 
продолжение: продолжении 
объективно: объективно 
владислав: Владислав 
аренда: аренда аренду 
виброускорения: виброускорения 
возрастать: возрастает 
удерживать: удерживать 
поставщик: поставщика 
деление: Деление 
предположительно: Предположительно 
выдача: выдачи 
полнота: Полнота 
наплав: наплавом 
тьюринг: Тьюринга 
детерминированный: детерминированных 
убедиться: убедиться 
разочароваться: разочаровавшегося 
контроллер: контроллера 
сущность: сущностей сущности 
совпадать: совпадали 
джеймс: Джеймс 
квадратичный: квадратичную 
капот: капотом 
выгодный: выгодным 
просматривать: просматривать 
газпромбанк: Газпромбанк 
нелинейность: Нелинейность 
сэмплов: сэмплов 
россиянин: россиян 
гидродинамический: Гидродинамические 
страдать: страдает 
независимость: независимости 
повлиять: повлиять 
авто: авто 
законодательство: Законодательство 
обозначение: обозначения 
анализбизнес: анализбизнес 
родиться: родилось 
родный: родного 
специализация: Специализация 
заимствоваться: заимствуются 
улов: улов 
обрываться: обрывается 
вевропе: вЕвропе 
упрощённый: упрощен упрощенная упрощенный 
операцийблокчейн: операцийБлокчейн 
шник: шник 
отслеживание: отслеживание 
ущерб: ущерб 
ред: РЕД 
многопрофильный: многопрофильная 
недопонимание: недопонимание 
протяжение: протяжении 
сопутствовать: сопутствующей 
тиун: Тиунов 
судить: судя Судя 
стабильный: Стабильное стабильную 
замок: замком 
проектирование: проектирование 
исполнять: исполняет 
предусмотреть: предусмотрена 
дорезонансном: дорезонансном 
допилить: допилить 
особый: особое 
горизонтально: горизонтально 
понятие: понятию понятие 
усложнить: усложненной 
межсетевой: межсетевыми 
примерно: примерно 
зарезонансного: зарезонансного 
издательский: Издательский 
фиксировать: фиксирующие 
слабый: Слабая слабую 
некий: некий 
фазовый: фазового 
игнорировать: игнорирует 
северный: Северной 
земля: земле 
воздействовать: воздействует 
цоды: ЦОДы 
блокчейна: блокчейна 
флешка: флешки 
попадать: попадают 
шрифт: шрифты 
сергей: Сергей 
разве: Разве 
монструозный: монструозное 
башлык: Башлыков 
беспрецедентный: беспрецедентными беспрецедентные 
диалог: диалога 
владение: владения 
независимый: независимый 
извлекаться: извлекается 
олег: Олега 
около: около 
присвоение: присвоения 
целомв: целомВ 
бенчмарков: бенчмарков 
контролировать: контролировать 
продление: продление 
стесняться: стесняйтесь 
монстр: монстра 
кейс: кейсы 
точнее: Точнее точнее 
вследствие: вследствие 
штамп: штампы 
сильно: сильно 
завершать: завершающее 
поощрять: поощряет 
помнить: помнит 
прийти: пришла 
дисбапланс: дисбапланс 
патентчитальный: ПатентЧитальный 
жизненно: жизненно 
дом: дом 
сравнимый: сравним 
скорее: скорее 
обратиться: обратиться 
предупреждать: предупреждать 
старший: старший 
кросс: кросс 
нетривиальный: нетривиальных 
ным: ным 
валидатор: валидатора 
оперативный: оперативную 
серьёзный: серьезного серьезная 
динамически: динамически 
солар: Солар 
мгновенно: мгновенно 
датасет: датасет 
поехать: поехали 
потенциально: потенциально 
философия: философию 
логично: логично 
издержка: издержки 
замечание: Замечание 
зачем: Зачем зачем 
зелёный: зеленым 
к: ко 
беларусь: Беларуси 
выразительный: выразительным 
побеседовать: побеседовали 
смекалка: смекалка 
тендер: тендерах 
подписка: Подписки 
тензор: тензора 
трафикадополнительно: трафикаДополнительно 
расшириться: расшириться 
задачинеобходимо: задачиНеобходимо 
необузданный: необузданный 
аппаратный: аппаратные 
вебинаре: вебинаре 
внутрь: внутрь 
сервисахитак: сервисахИтак 
нетривиальности: нетривиальности 
авиакомпания: авиакомпаниями 
сводиться: сводятся 
программированиеисследования: ПрограммированиеИсследования 
заработать: заработал 
выяснять: выяснять 
принадлежность: принадлежности 
жёстко: жестко 
обогащение: Обогащение 
обращаться: обращаться обращается 
граница: границей 
сетипри: сетиПри 
обслуживание: обслуживания 
экспертиза: экспертизой 
матрица: матрицы 
эксперт: экспертов 
нечестно: нечестно 
перераспределить: перераспределить 
тороп: Тороп 
существенно: существенно 
парочка: парочка 
индустрия: индустрии 
вручную: вручную 
смотреть: см смотрю 
винт: винтов 
отличиться: отличился 
секьюрный: секьюрный 
для: для Для 
молоток: молотком 
однобокий: однобокий 
данныххранение: данныхХранение 
продвижение: продвижения 
стремление: стремления 
бд: БД 
государство: государства 
неактивный: неактивными 
интуиция: интуиции 
ретушь: ретуши 
одинаковый: одинаковой 
между: между 
путать: путать 
дорожка: дорожек 
маркировать: маркировать 
потребляться: потребляется 
прим: Прим 
искусство: Искусство 
одновременный: одновременных 
вестись: ведется 
пропустить: пропустить 
логотип: логотип 
защитить: Защитите 
продаваться: продается 
паровоз: паровоза 
калькулятор: Калькулятор 
ухудшать: ухудшало 
алгоритмический: алгоритмической 
отметить: отметил отметить отмеченная 
равно: равно 
иерархический: иерархического 
маркетолог: маркетолог 
каков: Каковы 
данныхудалениеудаление: данныхУдалениеУдаление 
относительно: относительно 
перестроение: перестроение Перестроение 
виталий: Виталий 
нспк: НСПК 
шагепрефикс: шагеПрефикс 
наоборот: наоборот 
гужов: Гужов 
геоцентрический: геоцентрической 
введение: Введение 
противный: противном 
посылка: посылок 
свежий: свежая 
услышать: услышав 
пермь: Перми 
усложнение: усложнению 
получиться: получился 
пилот: Пилот 
совместимость: совместимости 
справедливо: справедливо 
контрфактическое: контрфактическое 
прочее: прочего 
соотношение: соотношения 
внутри: внутри Внутри 
иерархия: иерархии 
почувствовать: почувствовал 
имитировать: имитировать 
пытаться: пытается 
никогда: никогда 
интерактивный: интерактивного 
сформировать: сформированы 
подумать: подумайте 
структурировать: структурировать 
прояснить: прояснить 
соединить: соединенных 
простаивать: простаивает 
кнорозова: Кнорозова 
видеотелефония: видеотелефонии 
затрагивать: затрагивают затрагивать 
справляться: справляется 
акция: акций 
маркетплейсы: маркетплейсы 
исполняться: исполняется 
прибыльность: прибыльность 
основание: основании 
тянуть: тянуть 
согласовать: согласовать 
приготовление: приготовления 
айти: АйТи 
многообещающий: многообещающую 
надо: надо 
перезапустить: перезапустить 
закономерность: закономерности 
тг: ТГ 
уменьшать: уменьшать 
луч: лучом 
деятельность: деятельность 
просить: просит 
временной: временного временным 
вероятно: вероятно 
микросервисов: микросервисов 
специализированный: специализированных 
международный: международном 
батч: батч 
десятикратный: десятикратный 
сбербанк: Сбербанком 
добавилисьтакже: добавилисьТакже 
ру: ру 
копирайтеры: копирайтеры 
примитив: примитивы 
балансировщик: балансировщику 
козловруководитель: КозловРуководитель 
возможно: возможно 
сертифицированный: сертифицированных 
дух: Дух 
рыскать: рыскать 
нуль: нулями 
влад: Влад 
автотестов: автотестов 
закрытый: закрытыми 
поместить: поместим 
выбрасываться: Выбрасывается 
желательный: желательным 
зачисление: зачислению 
ломота: ломота 
официально: официально 
игорь: Игорь 
нерешаемый: нерешаемыми 
вибронагруженности: вибронагруженности 
таки: таки 
выполняться: выполняются выполняется выполняться 
дисплей: дисплей 
закончить: закончили 
слишком: слишком 
хабах: хабах 
причинять: причинять 
пята: пята 
поговорить: поговорим 
расшифровать: расшифруем 
мышка: мышки 
независимо: независимо 
форматировать: форматировать 
заболевание: заболеванием 
высокоуровневый: Высокоуровневый 
точечный: точечно 
невысокий: невысоких 
ясный: ясное 
изображенийграфический: изображенийГрафический 
перекладывание: перекладывание 
сэмпле: сэмпле 
успеть: успели 
дверь: дверь 
мутация: мутацию 
рост: ростом 
закрутить: закрутить 
акцентировать: акцентировать 
проектный: проектную 
приколачивать: приколачивают 
неопределённый: неопределенного 
домашний: домашних 
традиция: традициях 
сбалансированность: сбалансированности 
готовность: готовность 
динамичность: динамичность 
аргумент: аргумента 
представительство: представительства 
гост: ГОСТ 
подразумевать: подразумевает 
удержание: удержания 
концевой: Концевая 
легенда: Легенда 
дц: ДЦ 
нянька: нянькой 
перемещение: Перемещение перемещение 
платёжный: платежные 
трансформация: трансформации 
соблюдать: соблюдать 
адаптировать: адаптировать 
комплект: комплекты 
световой: световые 
хабр: Хабр 
скольжение: скольжения 
обязательство: обязательствам 
ибо: ибо 
скачать: Скачайте 
проставить: Проставленные 
гол: голов 
фото: фото 
согласование: Согласование 
фрезерование: фрезерованием 
барс: Барс 
освобождать: освобождает 
спрос: спрос 
ростелеком: Ростелеком 
эйнштейн: Эйнштейн 
писатель: писатель 
быстро: быстро 
влиять: влияет 
привлекательный: привлекательным 
январь: января 
переживать: переживает 
квантизованы: квантизованы 
сытый: сытых 
скармливать: скармливать 
недельный: недельного 
инфа: инфа 
подтвердить: подтвердить 
крок: КРОК 
гений: Гений 
патентфинтехпроектсберизобретение: патентфинтехпроектсберизобретение 
течение: течение 
сострадание: состраданием 
диего: Диего 
безумный: безумных 
золотой: золотого 
нормально: нормально 
приверженный: привержены 
ализар: Ализар 
артём: Артем 
правление: правления 
финальный: финальная 
отдельно: отдельно 
выброс: выбросе 
вход: входа 
кредит: кредитов 
цб: ЦБ 
фасад: фасад 
счесть: сочла 
открыться: открывшемся 
почтаобъектные: почтаобъектные 
советник: Советник 
билайн: Билайна 
упросить: упросил 
санкт: Санкт 
видеонаблюдение: видеонаблюдения 
переиспользование: переиспользование 
консольный: консольной 
вставлять: вставлять 
млрд: млрд 
подпортить: подпортить 
требовательный: требовательны 
доменный: доменное 
ланита: ЛАНИТ 
лазерный: лазерным 
понадобиться: понадобиться 
оформление: оформления 
модифицировать: модифицировать 
старое: Старое 
издание: изданиям 
яндекс: Яндекс 
сожаление: сожалению 
успешно: успешно 
арендный: арендные 
истинно: истинно 
ит: ИТ 
долго: долго 
базироваться: базируется 
нейросеть: нейросеть 
уступить: уступил 
трудноустранимый: трудноустранимый 
прогнозировать: прогнозируемых 
закрывать: закрывает 
гадать: гадать 
параллельно: параллельно 
симметрично: симметрично 
полезно: полезно 
арена: арену 
стартап: стартапов 
принадлежать: принадлежит принадлежат 
оснастка: оснастку 
вольф: Вольфа 
несмотря: несмотря 
изморозить: Изморозь 
встретить: встретит 
бэкенд: бэкенд 
ликвидация: ликвидацию 
аккаунт: аккаунт 
объяснить: Объясните 
проблемачасто: ПроблемаЧасто 
учить: учить 
сложносоставной: сложносоставная 
соответствующий: соответствующие 
снг: СНГ 
копироваться: копируются 
выпуск: выпускам 
приручить: приручить 
аудит: аудит 
представляться: представляется 
недеформируемый: недеформируемый 
стоять: стоят 
скажем: скажем 
рейнольдс: Рейнольдс 
валах: валах 
привязка: привязкой 
возвышать: возвышаете 
скручивание: скручивания 
интеллектинтервью: интеллектИнтервью 
кодпримеры: кодПримеры 
принудительный: принудительного 
полностью: полностью 
термин: терминах 
