мой: мой моего моих моя 
бросить: бросили бросил бросила 
задевать: задеваю 
здоровый: здорова 
худой: худого худой 
сюда: сюда 
конечно: конечно 
наружность: наружность 
полный: полная 
перчатка: перчатках перчатки 
развариться: разварившейся 
белый: белыми 
дальний: дальний 
царствование: царствования 
след: следы 
нахмуриться: нахмурясь 
отворачиваться: отворачиваясь 
ведь: Ведь ведь 
рука: руками рукой руки руку 
обыкновенный: обыкновенная 
наложить: наложить 
сегодня: сегодня 
заходить: заходил 
пахнуть: пахло 
голова: головой голове голову 
под: под 
ну: Ну 
столь: столь 
любить: любил любить любила люблю 
слеза: слез 
дать: дала дали 
нибудь: нибудь 
оскорбительный: оскорбительней 
проходить: проходило проходит 
хороший: получше хороша лучшие хороши 
жена: жена жену 
волшебно: Волшебно 
округлый: округлые 
посетитель: посетителей 
один: одном одним одной Одно 
садиться: садясь 
же: же 
женщина: Женщина женщина 
мало: мало 
видаться: видались 
ах: Ах 
выкинуть: выкинул 
аллея: аллеи 
или: или 
сходство: сходство 
щека: щек 
пенять: пеняй 
дорогой: дорогое дороже 
такой: такой такое такими 
бок: бок 
мёртвый: мертвых 
говорить: говорят говоришь говорить говоря 
сенцы: сенцы 
значит: Значит значит 
вдоль: вдоль 
минута: минуты 
большой: большом 
татарский: татарских 
всё: Все все 
век: век 
тоже: тоже 
ум: ума 
пять: пять 
текст: Текст тексте 
похожий: похожий похожая 
лицо: лицо лицом 
весь: всем весь вся 
хмуро: хмуро 
он: него он его Он 
уж: уж 
эй: Эй 
сказать: сказал сказано сказала сказать скажу 
воротник: воротником 
мота: мот 
пытливый: пытливо 
глаз: глазам глаза глазами глаз 
вот: вот 
суровый: суровой 
довольно: довольно 
военный: военных военный военном 
бог: бог боже Боже 
нельзя: нельзя 
сайт: сайте 
стоячий: стоячим 
давно: давно Давно 
истинно: истинно 
вода: воде 
просмотр: просмотров 
поцеловать: поцеловала поцеловал 
бессердечный: бессердечно 
глянуть: глянул 
ты: Ты тебя тебе ты 
горница: горницу горницы горница горнице 
лошадь: лошади лошадей 
ус: усами 
улыбка: улыбкой 
закрывать: закрывая 
бобров: бобровым 
потом: потом Потом 
поносить: поношенных 
изрезанный: изрезанной 
автор: Авторы 
я: мне Мне меня 
где: где 
туфля: туфлях 
ничего: Ничего ничего 
рысцой: рысцой 
жить: жить жила 
волшебный: волшебные 
простить: простила простил простить 
пегий: пегими 
тарантас: тарантас тарантаса тарантасе 
шинель: шинели шинель 
какой: каких Какой какие 
алексей: Алексей 
ответить: ответил ответила 
мы: нам мы 
козлы: козлах 
чернобровый: чернобровый чернобровая 
всякий: всякие всякого 
откровенно: откровенно 
мочь: мог может могла 
думать: думаю Думаю думал думай 
усталость: Усталость 
ни: ни 
порог: пороге 
верхний: верхней 
сударь: сударь 
вроде: вроде Вроде 
они: ним 
висок: висках 
отдохнуть: отдохнуть 
прибавить: прибавила прибавил 
образ: образ 
сделать: сделать 
краснеть: краснея 
для: для 
погост: погоста 
сапог: сапоге сапогах 
программирование: программирование 
стан: стан 
иван: Иван 
другой: другой другое 
отменно: отменно 
приказать: прикажете прикажи Прикажи 
до: до 
вслед: вслед 
тахта: тахты 
знать: знаю знать Знала 
скороговорка: скороговоркой 
изба: избы избе 
быть: Будь был будешь быть была Были было 
красный: красных красной 
вход: Вход 
выйти: вышел 
тридцать: Тридцать тридцать 
про: про 
остаться: осталась 
только: только 
смоляной: смоляной 
объяснять: объяснять 
подходить: подходя 
изменить: изменила 
вы: вас вам вы 
уезжать: уезжали 
окно: окну окно окна 
рост: роста рост 
прежний: прежнего 
связь: связи 
прекрасный: прекрасна 
осенний: осеннее 
ненастье: ненастье 
стать: стали стал 
угол: углу углам угол 
стройный: стройнее стройный 
исчезнуть: исчезли 
показать: показано 
кофточка: кофточкой 
свой: свои свою своего 
кто: Кому кто кому Кто 
красивый: красивая красивое 
тем: тем 
замшевый: замшевых 
бы: бы 
нечто: нечто 
носить: носят 
давать: дает давать 
щуриться: щурясь 
надо: надо 
грудь: грудями 
иметь: имела имел 
извинить: Извини 
пушок: пушком 
забываться: забывается 
волос: волосы 
обожать: обожал 
время: времени время 
лавка: лавки лавку 
год: лет годами Лет 
что: что Что чему 
на: на На 
козёл: козел 
при: При при 
александр: Александром 
друг: друг 
негодяй: негодяй 
сколько: сколько Сколько 
мельком: мельком 
коснуться: коснулся 
правда: правда 
дело: дело 
хозяйка: Хозяйка хозяйка 
грязь: грязью 
забыть: забыть 
который: которые которую которое которой 
печь: печь печи 
поздно: Поздно 
старинный: старинного 
николенькой: Николенькой 
прямо: прямо 
вскоре: вскоре 
небось: Небось 
самолюбие: самолюбие 
удлинённый: удлиненное 
уметь: уметь 
лишь: Лишь 
последний: последние 
лёгкий: легкая легкие 
седина: седину 
петербургский: петербургского 
хотеть: хотела хочешь 
точно: точно 
никто: никого 
встать: встал 
приезжий: Приезжий 
оказаться: оказался 
палата: палата 
опоздать: опоздать 
обида: обиды 
печный: печной 
вспоминать: вспоминал вспоминать 
мать: мать 
пообедать: пообедать 
она: ее Она она ней нее 
покрыть: покрытый покрытой 
николаевский: николаевской 
не: Не не 
далёкий: дальше 
бледный: бледное бледной 
вырасти: выросла 
надежда: надежд Надежда 
поехать: поехали 
крикнуть: крикнул 
бакенбарда: бакенбардами 
близкий: ближе 
когда: Когда когда 
справедливый: справедлива 
длинный: длинной 
мел: мелом 
по: по 
взгляд: взгляд 
треугольный: треугольным 
это: Это это этого 
дверь: дверь двери 
быстро: быстро 
так: так Так 
память: памяти 
сам: сама Сама 
словно: словно 
торопливо: торопливо 
содержательница: содержательница 
наш: наш наших 
дождь: дождями 
можно: можно 
попасть: попала 
болезненно: болезненно 
прижать: прижав 
вовремя: вовремя 
счастливый: счастлив 
шерстяной: шерстяной 
алый: алый 
верхом: верхом 
среди: среди 
золотистый: золотистый 
цыганка: цыганку 
пол: пол 
теперь: теперь 
нет: нет Нет 
соединяться: соединялись 
деньга: Деньги 
опять: опять 
опрятно: опрятно 
тот: тех ту 
чёрный: черной черные черными 
алексеевич: Алексеевич 
горячий: горяча 
с: Со со 
закат: закату 
липа: лип 
колея: колеи колеями 
гнать: гнал 
октябрь: октября 
история: История история 
чисто: чисто 
час: часа 
шлёпать: шлепали 
залить: залитой 
проглянуть: проглянуло 
сладко: сладко 
хозяйствовать: хозяйствовать 
стол: стол столом 
стоять: стояло стояли 
кучер: кучер Кучер 
самый: самых самая самое 
глядеть: глядела глядя глядел 
распространить: распространено 
тёмный: темных темными Темные темным темные 
пора: пору пор 
после: после 
цвести: цвел 
возраст: возрасту 
там: там 
разбойник: разбойника 
расти: рос 
себя: себя 
дорога: дорог 
подбородок: подбородок 
наконец: Наконец 
господин: господах господа 
отчий: Отчего 
приотворить: приотворив 
бунин: Бунин 
чистый: чистой 
станция: станция 
покраснеть: покраснел 
солнце: солнце 
губа: губе 
борода: бородой 
восемь: восемь 
пробрить: пробрит 
раскрыть: раскрыл 
но: Но но 
неправда: неправда 
грязный: грязные 
забормотать: забормотал 
уже: уже 
вынуть: вынув 
гусыня: гусыни 
сухо: сухо 
налево: налево Налево 
курчавиться: курчавились 
за: за 
без: без 
поезд: поезду 
светило: светило 
грубо: грубо 
седой: седые 
пожалуйста: пожалуйста 
оформление: оформление 
красота: красоту красоте 
прилично: прилично 
возлагать: возлагал 
помнить: помните Помнишь Помню 
заслонка: заслонки 
милый: милый 
совесть: совести совестью 
ребёнок: детей 
строгий: строгий строгим 
держать: держишь держать 
говядина: говядиной 
картуз: картузе картуз 
самовар: самовар Самовар 
изволить: изволили изволите 
понимать: понимаешь 
вдова: вдова Вдова 
хвост: хвостами 
спросить: спросить 
подумать: подумать 
сдвинуть: сдвинув 
баба: Баба 
оспа: оспы 
хранить: хранило 
раз: раз Раз 
грубость: грубостью 
ещё: еще 
войти: вошел вошла 
впрочем: Впрочем 
погонять: Погоняй 
отвал: отвалом 
сидеть: сидел 
начёс: начесами 
почтовый: почтовая 
пожилой: пожилую 
серый: серой 
нагнуться: нагнувшись 
ровно: ровно 
то: то 
частный: частная 
чем: чем 
выпрямиться: выпрямился 
сын: Сына 
добро: Добро 
лавров: лавровым 
вид: видом 
усмехнуться: усмехнулся 
простой: простых 
сорок: сорок 
жизнь: жизни 
усталый: усталым усталый 
переночевать: переночевать 
новый: ново новый 
подпоясать: подпоясанном 
пока: пока 
высокий: высокого 
поднять: поднял 
казённый: казенная 
подвязать: подвязанными 
живот: животом 
твой: твое 
клим: Клим 
стыдиться: стыдился 
дом: дома 
честь: чести 
недобрый: недоброй 
снять: снял 
как: Как как 
звать: звала 
укорять: укорять 
произведение: произведений произведения 
читать: читать 
разговор: разговор 
правый: правый 
темноволосый: темноволосая 
платок: платок 
нога: ногу ноги 
долго: Долго 
иов: Иова 
комар: Комаров 
менее: менее 
кругом: Кругом 
заглядываться: заглядывались 
разве: Разве 
потерять: потерял 
да: Да да 
попона: попонами 
армяк: армяке 
николай: Николай 
рассеянность: рассеянность 
упираться: упиравшейся 
приостановиться: приостановилась 
крепкий: крепкий 
хотеться: хочется 
сквозь: сквозь 
мужик: мужик 
старик: старик 
сердце: сердца 
взбежать: взбежал 
отдать: отдал отдала 
этот: Эта 
прелестный: прелестна 
вольный: вольную 
отрывисто: отрывисто 
смотреть: смотрела 
упор: упор 
ровный: ровным 
ваш: ваше 
лужа: лужам 
слово: слова 
ход: ходу 
стих: стихи 
очень: очень 
отходить: отходя 
странно: странно 
вопрошать: вопрошающий 
тепло: тепло 
оттого: Оттого 
мелкий: мелкие 
плечо: плечи 
больший: большими больших 
молодость: Молодость молодость 
холодное: холодное 
занимать: занимавшая 
полуподнятым: полуподнятым 
если: если Если 
подкатить: подкатил 
замужем: Замужем 
видно: видно 
подкова: подковы 
редкий: редкой 
тройка: тройка 
крутой: крута 
менять: меняя 
серьёзный: серьезной серьезный 
вздор: вздор 
приятно: приятно 
уходить: Уходи 
подавать: подавать 
крыльцо: крыльцо 
кой: кое 
пожить: пожить 
свет: свете 
наглец: наглец 
любовь: Любовь любовь 
чистота: чистоту 
пустой: пустые 
вымыть: вымытые 
почему: Почему 
стыд: стыда стыдом 
хорошо: хорошо 
жёлтый: желто 
пола: полы 
остановиться: остановясь остановился 
тульский: тульских 
левый: левом 
закидать: закиданный 
постоялый: постоялой 
голенище: голенищем 
многий: многими 
лист: листом 
превосходительство: превосходительство 
ли: ли 
низкий: Низкое 
сейчас: сейчас 
поле: поля 
слегка: слегка 
зашагать: зашагал 
пошлый: пошлая 
капуста: капустой 
придерживать: придерживая 
юбка: юбкой 
прочий: прочем 
покушать: Покушать 
горячка: горячку 
тотчас: тотчас Тотчас 
кухонный: кухонная 
качать: качая качал 
пожаловать: пожаловать 
мелькать: мелькавшие 
темноликий: темноликий 
богатеть: богатеет 
шестьдесят: шестьдесят 
рассказывать: рассказывать 
о: обо 
служить: служишь 
шиповник: шиповник 
из: из 
сбросить: сбросил 
никогда: никогда 
выбирать: выбирая 
решительно: решительно 
вести: ведешь 
мундир: мундире 
чувство: чувств 
щи: щами 
подойти: подошла 
верно: Верно 
подборка: Подборка 
число: число 
протекший: протекшей 
неприязненно: неприязненно 
бровь: брови 
библиотекереклама: библиотекеРеклама 
слякоть: слякоти 
тут: тут 
вместе: вместе 
от: от 
книга: книге 
туго: туго 
скатерть: скатертью 
белеть: белела 
провести: провел 
невнимательно: невнимательно 
