автор: авторов Автор авторы Авторы автором авторами автор 
антивирус: антивирусами антивирус антивирусов 
сетевой: сетевые сетевых Сетевые сетевую сетевой сетевым 
день: день дней дне дня 
противоположный: противоположным противоположный 
активный: активным активные активного активных активное активен 
квалификация: квалификация квалификациях 
доступность: доступности 
мацяс: Мацяс 
полный: полную полного полной полный полном полная 
интернет: Интернета Интернете интернету интернет интернета Интернет 
правильный: правильный правильные правильное правильном 
какой: каких какие Какими каком Какие каким какого какая какими какое какой какую 
убедиться: Убедился убедимся убедиться 
форма: форма Форма формы форму форм форме 
пара: пар пару пара 
центр: центра центры центров центре центрах центрами центрам 
подверженный: подвержен подвержено подвержены 
русский: Русский русские 
немножко: немножко 
выжимка: выжимку 
реальность: реальности 
упрощать: Упрощает упрощает упрощающая 
встретиться: встретиться 
функциональность: функциональность функциональности 
глаз: глазами глаза глаз 
чтение: чтения чтение Чтение 
начать: начать начал Начали Начну начнет начали 
лихорадочно: лихорадочно 
использовать: использованы используемой использованные использовала Используем используемая использующий используя использован используют использовать использует используем используемых используемые использовали использую 
слюна: слюной слюны слюна 
оценивать: оценивали оценивать 
опубликовать: опубликована опубликованные 
подход: подход подходе подходами подхода Подход Подходы подходу подходов подходы 
столкнуться: столкнулся столкнулось столкнулись 
отказываться: отказываются 
подходить: подходила подходят подходит подходить 
газовый: газовыми 
перенаправлять: перенаправляя 
сообщество: сообщество Сообщество сообществу сообщества сообществе 
беспроводный: беспроводные беспроводной беспроводными 
аналогичный: аналогичные аналогичен аналогичную аналогичный 
вычислительный: вычислительных вычислительной 
лайнер: лайнере 
выпуск: выпуск Выпуск 
документ: документы документа документов документами документах Документы документ документам 
высокий: высокий высокой высокого высокая высшей высокое высокие 
достижимый: достижимых 
овской: овской 
родный: родная родного родной 
сведение: сведения 
публичный: публичная публичные публичную публичный публичных 
специалист: специалисты специалист специалистов Специалист 
выявление: выявления выявление выявлении 
фоновый: фоновом 
позиция: позицию 
сигнал: сигнал сигнала 
изложить: изложенных изложено изложить 
оседать: оседает 
попадать: Попадают попадать попадают попадаем 
зданийконстантин: зданийКонстантин 
принять: принять принято принятых Примем принял Принято примем 
рефакторить: рефакторить 
один: одно Одно одним один одном одни одной одну Один одна Одним одному одного 
числитель: числитель числителем числителя 
аргумент: аргумент аргументом аргументов аргументами 
сознательный: сознательным 
позволять: позволяют Позволяет позволяет позволяющей позволяющий позволяющие 
длина: длина длины длину длиной 
ценный: ценные ценный ценным 
архитектор: архитектор 
цветной: цветными 
новый: новым Новый новую нового новый новому новые новой новыми Новые новая Новая новое новых 
клавиатура: клавиатуры клавиатура Клавиатура клавиатурой клавиатуру клавиатуре 
роль: роли роль ролью 
страдать: страдают страдает Страдают 
рентгенограмма: рентгенограмму рентгенограммам рентгенограммами рентгенограмм Рентгенограммы рентгенограммы 
выступление: выступлении выступления 
быть: будет будут Был была будете Было будь были был Были буду суть быть будучи Будет Была Суть было будем 
релевантность: Релевантность 
входить: входят входит 
аллокация: аллокации 
программированиепрограммирование: программированиеПрограммирование 
открытый: открытым открытые Открытое открытых открытый открытом 
обмен: обмена обмен Обмен 
переопределить: переопределить переопределенной переопределим 
запрос: запросу запрос запросам запросы запроса запросами запросов 
доставить: доставить 
пометка: пометку пометкой 
джуныдети: джуныДети 
сутки: сутки Сутки суток 
мод: модов 
прозрачный: прозрачно 
конкурс: конкурс 
прописной: прописные 
цена: цена цены 
способ: способы способе способа способом способ способов способами способам 
кодаесть: кодаЕсть 
оптимизатор: оптимизатор 
алгоритм: алгоритма Алгоритмы алгоритмах алгоритмами алгоритмы алгоритм алгоритмов 
непонятный: Непонятна 
проникать: проникает проникая проникают 
старший: Старший старше 
расти: растут расти Расти росло растет 
специальный: специальный специальную специальных 
наука: наук науке наука науки 
приходиться: приходится 
система: системах системе системам систему система системами систем системы системой 
годиться: Годится 
совершенствоваться: совершенствоваться 
найти: найден нашел найдено найденные Найдя найти найдешь найдет 
низкокачественный: низкокачественной 
эксклюзивный: эксклюзивные 
фотографировать: фотографировал 
нужный: нужен нужного нужный нужны нужных нужна нужные нужному нужной 
хотеть: хотите Хочешь хочу хотим хотели хочет хотел 
фиолетовый: фиолетовый фиолетовая 
артефакт: артефакты 
несколько: нескольких несколько нескольким Несколько несколькими 
задача: задачи задачу задач Задача задачами задачей задача задачам задаче задачах 
редактор: редактора редактором редакторе редактор редакторах Редактор 
дампинг: Дампинг 
современный: современное современным современных современными современный современную Современные современной Современного 
родиться: родились 
место: место месте места мест местах 
здоровье: Здоровье здоровье здоровьем здоровья 
типовой: типовой Типовое типовые типовым типового 
кривая: кривой Кривая кривые кривая кривыми кривых кривую 
перепад: перепады 
заинтересованный: заинтересованный заинтересованных заинтересованные заинтересованным 
указать: указать указаны указано указана Укажем указал указанным 
сопровождать: сопровождает 
переход: переход перехода 
помочь: помогло помогли поможет помог помочь помогла 
поправить: поправить 
лояльность: лояльность 
трафик: трафика трафик 
ваш: ваше вашу ваш вашей вашем вашему вашего Ваш ваша ваши ваших 
нейросетей: нейросетей 
рука: руках руки 
удалённый: Удаленная удаленная удаленной удаленные удаленный удаленно удаленном удален 
согласно: Согласно согласно 
неполный: неполная 
антиэлектрон: антиэлектроном 
аналитический: аналитический аналитическое аналитического 
код: кодов код кодом коду коде кода 
мтс: МТС 
влияние: Влияние влиянию влияния влияние влиянии 
учиться: учатся Учимся учиться 
формализация: формализации Формализация 
кровоточить: кровоточат кровоточить 
прокачивать: прокачивать Прокачиваем 
порядок: порядок порядка порядке 
коронка: коронкой коронках 
вопрос: вопросов вопросом вопросах вопрос Вопрос вопросы вопроса 
эксперт: эксперты Эксперты Эксперт экспертов экспертам 
описание: Описание описаниях описанию описаний описания описании описание 
ясность: Ясность 
никотиновый: никотиновый никотиновых никотиновые 
лотерейный: Лотерейного 
текущий: текущий текущей текущие текущим 
короткометражка: короткометражку 
ежедневно: ежедневно 
решить: решить решенной Решить решит решили решено решена 
работать: работают работая работать Работает работало работающих работаем работал работающий работает Работать работали Работая работаю 
войти: вошли Войти вошло Войдите 
стенд: стендов стенды стенд стендах стенде 
саентистов: саентистов 
многотысячелетний: многотысячелетнюю 
интересоваться: интересующихся Интересующихся интересуетесь 
лейкоплакия: лейкоплакия Лейкоплакия 
дробно: дробно 
ужас: ужас 
разрабатывать: разрабатывает разрабатывали разрабатывают разрабатывал разрабатывать 
протокол: протокол Протоколы протоколам протоколом протоколов протоколы 
боль: боль боли 
правительство: правительством 
зайти: зайти 
изготовить: изготовленное 
требование: требованиями требования требованиям требований требование требованием 
космический: космические космических космической космического 
банк: банки банка Банк банках банк 
верхний: верхнем верхних ВЕРХНЕМ верхняя 
перейти: перейти Перейти 
использоваться: использоваться используется использовалась Используется используются использовался 
обратиться: обратится обратимся обратиться 
второй: Вторая второго второй вторых Второй втором вторым 
дипфейк: дипфейк Дипфейк 
наш: наш нашими наше Нашей нашего наших нашем Наша нашей нашу нашему наши 
жилой: жилом 
понимать: понимаю понимает понимать понимают понимала понимая 
кровь: крови 
реализовать: реализующий реализуют реализована реализуя реализующие реализовала реализовано реализовать реализуйте реализован 
предполагать: предполагает предполагали предполагаю 
выбрать: Выбрать выбрал выбрали выбрать выбранный выберите выберем выбрав выбранном Выбрав выбранного 
скан: сканов сканах 
поиск: поиска поиск поисках поиску Поиск поисков 
сокращаться: сокращаются 
хардкодить: хардкодить 
телеком: телекомов 
проявляться: проявляется проявляться 
даваться: дается 
компаньон: компаньонов компаньоны 
переменный: переменных переменная переменную переменными 
абразивный: абразивные абразивной 
следующий: следующего следующем следующим следующими следующей следующий следующие следующих Следующие следующая следующее Следующий 
пространственный: пространственной пространственную пространственными 
получить: получила получит получено полученного получим получат Получить полученные получите полученному получить Получите получившее получил 
год: годом году лет годы год годах года годов 
пристыковываться: пристыковываться 
коллаборация: коллаборации 
проект: проекте Проектом проектах проектами проектом проекты проектов Проект проекту проекта проект 
детектировать: детектировать 
фрагментация: фрагментации Фрагментация фрагментацией 
поддержка: поддержкой поддержка поддержку поддержке поддержки 
джордж: Джордж 
разбор: разборе 
заменить: заменят заменить 
аудиозвонки: аудиозвонки 
постепенный: постепенную постепенной постепенная 
кристаллик: кристалликов 
проходить: проходили проходил проходит проходить проходящие проходя проходят 
инструкция: Инструкция инструкциям инструкции Инструкции инструкцию инструкций 
вкусовой: вкусового вкусовым вкусовые 
проблема: Проблему проблем проблемам Проблема проблемы Проблемы проблему проблема 
начало: Начало началом начала начале 
равно: равно 
назвать: назвал названная Назовем назвать 
выступать: выступает 
продьюсер: продьюсер 
иначе: иначе 
группа: группа группы Группа Группы группам групп группу 
наблюдение: наблюдение наблюдения 
куда: куда 
ежедневный: ежедневная ежедневного ежедневной 
настроить: настроенного настроили настроил настроим настроить 
инструмент: инструментами инструментом Инструмент инструментах инструментов инструменты Инструменты инструмента инструментам инструмент 
дополнительно: дополнительно 
волк: Волк волка 
интересный: интересной интересные интересное интересны интересен интересна интересную интересных Интересная интересного интересным 
заставить: заставить 
опрос: опрос опроса 
область: области областей областями область 
ошибка: ошибкой ошибкам ошибок ошибка ошибками Ошибок ошибке ошибки 
инженерный: Инженерные инженерного инженерных 
направление: направлением направление направлению направления 
хранилище: хранилища хранилище хранилищами 
представлять: представляет представляющая представляющих представляют представлять 
встраивание: встраивания Встраивание 
физика: физики Физика физике 
поскольку: Поскольку поскольку 
образ: образ образом образе образов образа образы 
директор: директор 
выдача: Выдача выдачи выдачу 
игрмодыскайрим: игрмодыскайрим 
осмотр: осмотр 
затрагивать: затрагивающий затрагивающую затрагивает затрагивают 
схемотехника: Схемотехника схемотехника 
отторжение: отторжения 
политика: политики Политика 
магический: магическая 
требовать: требуя требует требовали требуемая требующую требуют требовать требуемого требуемые 
поревьювить: поревьювить 
экзотический: Экзотические экзотическими экзотические экзотическом экзотический 
трансформация: трансформации трансформация трансформаций 
нежный: нежными 
полагаться: полагались полагаться 
идентификатор: идентификаторы идентификатор идентификаторов идентификаторами 
разминировать: разминировать 
участник: участниках участника участников Участник 
вспомнить: вспомним вспомнить 
выдающийся: выдающихся 
связанный: связанных связанные связанной 
поисковик: поисковик 
вполне: вполне Вполне 
гуру: гуру 
широкий: широкого широкое широкий широкие 
адекватный: адекватные 
европейский: Европейского европейских европейский европейском 
важный: важного важную важных важное важные важным важен важный Важным важна важнейшая 
общий: Общий общий общую общее общие общему общая общим общем общего 
потерять: потерять 
компания: Компании компаниями компаний компании компания Компания компанией компаниям компанию 
въедаться: въедался 
обратный: обратной обратная обратную 
питание: питания питание 
навык: навыков навыками навыка навыки 
дайджест: Дайджест 
дизайн: дизайн Дизайн 
инфраструктура: инфраструктуру инфраструктура инфраструктурой инфраструктуры инфраструктуре 
долговременный: долговременных 
логический: логический логического 
показывать: показывает показывают показывать Показывайте 
умный: умные умный Умный умному умного умном умным Умные умных 
плавать: плавающей 
андрей: Андрея Андрей 
кто: кем кто кому Кого кого Кому Кто 
меняться: меняются меняться менялся меняется 
тупиковый: тупиковый 
человеческий: человеческих человеческий человеческой 
трудный: трудная труднее 
нюанс: нюансы нюансов 
минцифры: Минцифры 
доработка: доработке 
кожа: кожи 
теоретический: теоретические 
курение: курение курения курением Курение курении 
закладка: закладок Закладки закладка Закладка закладки 
мера: мер меры мере 
уровень: уровням уровни уровень Уровень уровня уровней уровне уровнях уровнем уровню 
атака: атаки атаках Атаки атаке атаку атаками атакам атака Атака атак 
специализация: Специализация специализаций 
строить: строим строят строить строите 
невозможно: невозможно 
радость: радостях 
положительно: положительно 
санкт: Санкт 
старое: Старое старого 
датасеты: датасеты Датасеты 
сканирование: сканирований сканирование 
регистрация: регистраций Регистрация регистрации 
облако: облака облако облаком 
администратор: администраторов администратор администратором администратора 
индивидуально: индивидуально 
малый: малой малая меньших меньшими наименьшее меньшая 
обзор: обзоре Обзор обзор обзора 
зашить: зашитых 
сам: самих сам Сама самой самом самому сами Саму самим само сама Сам самого 
типично: типично 
история: истории История история историю Истории 
блокировкасуть: БлокировкаСуть 
для: для Для 
здание: зданиями 
корпоративный: корпоративной корпоративному корпоративную 
илья: Илья Ильи 
территория: территории 
основание: основании основания 
серия: серию серия Серия серии 
собирать: собирала собирает Собирая собирать Собираем собирают собираем 
близко: близко 
поступать: поступали поступаем поступает поступать 
советовать: советуют советуете 
баланс: баланс 
предмет: Предмет предметов предметами предметом предмет 
тезис: тезиса тезисы 
запустить: запущенными запущен запустила Запустим запустить запустим запущена 
правда: правда Правда 
выбирать: выбираете выбираем Выбираем выбирает выбирают 
проектный: проектной проектные Проектная проектных 
чиститься: чистится 
законодатель: законодатели 
иметься: имеющимися имеющейся имеются имеющимся имеющихся 
равновесие: равновесие 
бизнес: бизнесе Бизнес бизнесу бизнес бизнеса 
крок: КРОК 
ресурс: ресурса ресурсом ресурсов ресурсах ресурсы 
характерный: характерен характерно Характерный 
привести: приведенные привел приведены приведена приведен привести привело приведет 
подключать: подключаемая подключать 
засвет: засвет 
среди: среди Среди 
туториальный: туториальный 
простой: проще простым простое простого простую простой Простейший простом прост Простой простому простые простых проста 
уж: уж 
обретать: обретать 
распаковать: распаковать 
ждать: ждут жду ждать 
антиматерия: антиматерией Антиматерию Антиматерия антиматерии антиматерия 
принцип: принципу принцип принципов принципе Принцип принципы 
повреждение: повреждение повреждения Повреждение 
далеко: далеко Далеко 
содержимое: содержимого содержимое содержимым 
напиток: Напиток напитков напиткам 
замена: замена Замена замены замене 
предложить: предложит предложить предложило Предложить предложенный 
почасовой: Почасовая 
компилятор: компиляторы компилятора компилятором компилятор Компиляторы 
невозможный: невозможным невозможного 
исследование: исследованиях Исследование Исследования исследований исследованию исследования исследовании исследование 
импортозамещение: импортозамещения 
угодный: угодно 
чужой: чужой чужих 
необходимость: необходимости необходимость 
практический: практическая Практическая практической практического практические практических 
распределение: распределение Распределение распределением 
контакт: контакт контакте контакты контактами 
хабра: Хабра 
скидка: Скидка скидка 
парень: парни 
матмодель: матмодель 
поздний: Позже позже позднее поздних 
великолепие: великолепие 
пострадать: пострадает пострадают 
четыре: Четыре четыре четырьмя четырех 
интернетпочему: интернетПочему 
ниндзя: Ниндзя 
письмо: писем письмах письма 
составлять: составляющих составлял составляет составляют 
номинал: номиналом 
мониторит: мониторит 
горячий: горячим горячий горячей горячих Горячий 
вдохновлять: вдохновляли 
минимум: минимум 
слизистая: слизистую 
направляться: направлялся 
почта: почта почте 
результат: результатам Результатом результате Результаты результат результатах результатом результата Результат результаты результатов 
ссылка: ссылка ссылках ссылок ссылку ссылки ссылке Ссылка 
отлично: отлично 
зарегистрировать: Зарегистрирован Зарегистрирована 
техписатель: Техписатель 
вещь: вещи вещей вещь 
гельсодержащие: гельсодержащие 
математический: математического математическое математические 
управляемый: управляемых управляем управляемая 
исполнение: исполнению исполнении исполнением исполнения 
стараться: стараюсь старался стараемся старается 
весь: всем всей всего всех всеми всю весь Весь Всего вся всему Вся Всем 
выход: выходом выходе выходами 
акцент: акцент 
ягода: ягоды ягод 
электрон: электрон электронов электроном электронами 
политик: политиков 
то: То то 
щёлкнуть: щелкнув 
старый: старые старых старыми старую 
машина: машин машине машина машиной машины 
памятирекомендуется: памятирекомендуется 
обновить: Обновим обновим обновить Обновить 
поискать: поискать 
осторожность: осторожностью 
иметь: имейте иметь имеют имеет имеем имея имеющими Имели имеющих 
средство: средства средствами средство средств 
репутация: репутации репутацию 
главный: Главная главный главным главные Главные Главной 
опасаться: опасаться 
достаточно: достаточно 
стабильный: стабильную 
в: во Во 
рекрутер: рекрутеров 
купить: купить купил 
круиз: круиз 
машинный: Машинное машинное машинным машинном машинного 
услуга: Услуги услуг услуги 
очищаться: очищаются 
начинать: начинает Начинать начинаешь начинают начинала начиная 
температурный: температурного Температурный температурный 
почувствовать: Почувствуйте 
фундаментальный: фундаментальная фундаментальной 
транслировать: транслирующие 
скайрима: Скайрима 
конфигурировать: конфигурируемые 
создать: создадим созданной созданные создали создано созданный созданного создать создаст созданных создало создавший Создадим созданную 
грамматический: грамматических 
решаться: решается 
батарейка: батареек 
связать: связана связаны связано связан связать 
указанный: указанных указанную 
первый: Первое первый первые первого первой первом первым Первая первых Первым Первые первое Первыми Первый первую первая 
продавец: продавца Продавцы 
брекет: брекетов брекеты 
датасетов: датасетов 
иной: иное иного Иными иной иные 
реализация: реализацией реализация реализаций реализациях реализацию реализации Реализация 
пассивный: пассивные пассивных Пассивное 
никотин: никотина никотин 
поставить: поставленные поставить поставлена поставлен 
пришеечный: пришеечный 
грандиозный: грандиозные 
сообщение: сообщений сообщениями сообщения сообщение 
различие: Различие Различия 
файловый: файловая 
ткань: ткань ткани тканей тканях тканями 
россия: России Россия 
строение: Строение строение 
операция: операция операций операции 
статистика: статистику статистика статистике статистики 
развиваться: развиваются развивается развиваться развивалась развивался 
вводиться: вводился вводиться 
работа: работ Работа работы работа работе работой работу 
запросить: запросило 
носить: носят носить носящий 
бесспорный: бесспорных 
интегратор: интеграторы интегратора интеграторов интегратором интегратор интеграторам 
автоматический: автоматическую автоматическое автоматический автоматическим автоматической Автоматическая автоматическая 
динамика: Динамика 
особенность: особенность особенности особенностей особенностью 
сервисный: сервисными 
искать: искать искала ищут ищем ищет 
объять: объять 
терминология: терминологии терминология 
частично: частично 
явление: явления 
пародонта: пародонта 
ведущий: Ведущая ведущих Ведущий ведущий ведущая 
нелетучий: нелетучих 
перенос: переноса переносом 
воспаление: воспаление воспалении воспаления 
разум: разума 
база: база баз базе базы базой 
содержание: содержания содержании содержание 
композиция: композиции 
нормативный: нормативно 
кривизна: кривизна кривизны 
запылиться: запылившейся 
польза: пользу пользы польза пользой 
многий: многими многих многим Многим 
чуть: чуть Чуть 
символ: Символы символов символы 
дыхательный: дыхательного 
минигайд: Минигайд 
приветствоваться: приветствуется 
русскоязычный: русскоязычное русскоязычным 
спутник: спутника 
разрешение: разрешениями разрешения разрешений разрешение 
выяснить: выяснить Выясните 
юзер: юзер Юзер юзеров 
доля: доли доля 
неметь: немеет 
туда: Туда туда 
деталь: детали деталей 
контур: контур контуров контуром 
голосовать: Голосуй 
вейпов: вейпов 
западный: западных 
оставлять: оставлять 
соответствовать: соответствующем соответствует соответствуют соответствующий соответствующую соответствующей соответствовать 
возможность: возможностью Возможности возможностей возможность возможностях возможности 
плата: платы 
соскальзывать: Соскальзывая 
принимать: принимаемом принимает принимать 
согласный: Согласен 
давать: давать Даем дает дают дающем давайте Давайте 
публикация: публикаций Публикация публикацией публикации публикацию Публикации публикация 
это: Этим Это Этого этого этим этом это 
итеративный: итеративного итеративный 
задавать: задаем задает задавайте задавали задавать 
предсказать: предсказать предсказали предсказанных 
показаться: показаться показалось 
храниться: хранится хранятся хранящиеся 
инцидент: инцидентам инциденты инцидента инцидентов Инцидент инцидент 
технический: техническую Технический Технические Техническая технического технических техническим технической техническими техническое технические техническая технический 
государство: государства 
нарыть: нарыть 
записать: запишем записали записать Запишем записаны 
равный: равные равен равны 
целый: целые целую целый 
кусок: кусок куском куска 
длинный: длинной длинными 
дальнейший: дальнейшем дальнейшее дальнейшего дальнейших дальнейшей 
отвести: отвести 
нахождение: нахождения 
вот: вот Вот 
реализоваться: реализуется 
смотреть: смотрят смотреть смотрим Смотрите см 
заканчиваться: заканчивается 
передать: переданные 
проводной: Проводные проводными 
ассистент: ассистентами ассистенты ассистент ассистентов 
еврорегионе: еврорегионе 
настройка: настроек настройка настройкам настройки Настройка настройкой настройке настройками 
руководство: руководство руководства 
российский: российская российский российское российского 
сохранять: сохраняем 
помогать: помогаю Помогаем помогаешь помогает Помогайте помогают помогающей Помогает 
табличка: таблички табличкой 
предметный: предметной предметных предметного 
соответственно: соответственно Соответственно 
последующий: последующую последующая последующих последующие 
эпителий: эпителия эпителий Эпителий 
звук: звука звук 
угол: углов углом 
логотип: логотип логотипом 
окно: окон окна окно окне Окно 
потребовать: потребовали потребовать потребовав потребовало 
вход: входов входа входам вход 
обязательный: обязательная обязательные обязательными 
треск: треском 
больший: наибольший больших большим большую большие больший большего Большие большей большая 
прародитель: прародителей 
взаимодействие: Взаимодействие взаимодействие взаимодействия взаимодействий 
уникальный: уникального уникальным уникальны уникальная 
уязвимость: уязвимость уязвимости уязвимостей уязвимостями уязвимостям 
подпись: подписи 
зарегулировать: зарегулировать 
детство: детство 
часто: Часто часто 
очередной: очередном очередная очередным 
передача: передачу передачи 
они: Им них ними им они Они их Их ним ими 
подумать: подумали подумать 
конференция: Конференции Конференция конференций конференции конференцию Конференцию конференциях конференция 
оформление: оформление оформлении оформлению оформления 
ключ: ключей ключ Ключом 
написать: написать написана написанное написали написанному Напишите написанный Написать 
неприятный: неприятный неприятная 
положительный: положительной 
надстройка: Надстройка надстройками надстройках надстройки надстройка надстройкам надстроек надстройку 
поток: потоку потоков поток потоке потоки потока 
сталкиваться: сталкиваются сталкиваться сталкивалась сталкиваемся 
правильно: правильно Правильно 
обеспечивать: обеспечиваем обеспечивают обеспечивает обеспечивающим Обеспечиваем обеспечивать 
модем: модемом модем модема 
зрелость: зрелости 
актуальность: актуальность 
заключаться: заключаться заключается 
поднять: Поднять 
элемент: элементов элемента элементы элементам элемент элементами элементе 
мой: Мой моем моя мои моего Мои мой 
искажать: искажают 
разобраться: разобраться 
инфекция: инфекциям 
цирк: цирк 
количество: Количество количестве количества количеством количество 
стек: стеке стека стек 
улучшаться: улучшается 
комплекс: комплексом комплексами комплекс 
передаваемый: передаваемого передаваемым 
достойный: достойные Достойная 
ненадлежащий: ненадлежащую 
канал: каналы канал каналов канале каналами 
проанализировать: проанализировать 
друг: друзья друзей другом друг друга другу 
примечание: Примечание 
считать: считать считанном считают Считав Считать считает 
суд: суд 
комментировать: Комментировать комментируют 
производство: производство производства Производство производстве 
изменяемый: изменяемый 
пойти: пошла пошел Пошел пойдет 
миллион: миллионов 
нанести: нанесет 
сильный: сильных сильное сильный сильного Сильных сильными 
булевый: булевый 
приложение: приложениям Приложение приложениями приложений приложением приложения приложение приложению приложении 
методика: методика методики 
кислород: кислорода 
разговор: разговоре разговора разговор 
концепция: Концепция концепции 
правообладатель: правообладателя 
загрузить: загрузить загрузит загруженные загруженных 
о: обо об Об 
факт: факт фактов факта 
морфологический: морфологический 
учреждение: учреждениях учреждений учреждениям 
чувство: чувства 
материал: материала материалы материале материалов материал 
принадлежность: принадлежности 
эквидистанты: эквидистанты 
раз: разы раз раза 
гибкий: гибкой 
документация: документацией Документация документацию документация документации 
научный: научного научных научной научный научное 
тестовый: тестовой Тестовый тестовых тестовый Тестовая 
задачв: задачВ 
ячейка: ячеек 
мозг: мозгов 
минироваться: минируется 
наверное: наверное 
длиться: длится 
сборка: сборок сборка Сборка сборку сборки сборке 
предъявлять: предъявляет 
сократить: сократить 
желать: желающих желающим желающие желающий желающего 
болванка: болванка Болванки болванки 
скрипт: скрипт скриптов Скрипт Скриптом 
тейлор: Тейлора 
злоумышленник: Злоумышленники злоумышленниками злоумышленники 
испускать: испускают испускающие 
профессионал: профессионалы профессионалам 
продлить: продленный продленная продленного продлена продленной 
продукт: продуктом продуктов продуктам продуктах продукте продукта продукты продукт продукту 
разработчик: разработчиками разработчика Разработчики разработчику разработчиков Разработчикам Разработчик разработчикам разработчик Разработчику разработчики 
сложность: Сложность сложностей сложности 
одобрение: Одобрение одобрение 
скайрим: Скайрим 
интерес: интерес интереса 
демотивирующий: Демотивирующий 
защищать: защищают Защищают защищая защищаемой защищает 
пластина: пластин 
дмитрий: Дмитрия Дмитрий 
ввязываться: ввязываться ввязываются 
испытание: испытаний 
менее: менее 
радовать: радовать 
уведомление: уведомления 
сложный: сложны сложном сложным сложнее сложной сложных Сложный сложные 
кодаво: кодаВо 
компетентный: компетентные 
прикладной: прикладном прикладная 
закрыть: закрыть закроет 
собрать: собрал соберите собрать 
рнр: РНР 
функция: функцию функциям функции функцией функций функция функциями 
полировать: полирующие полируя 
переходить: переходить Переходим переходит перехожу 
системный: Системное системных Системный системные системного системным системной 
литература: литературы литературе 
десятка: десятками 
решать: решая Решать решаемой Решаемая решать решают решает 
высокоуровневый: высокоуровневым высокоуровневый высокоуровневые Высокоуровневый 
применить: Применить применить применены 
техноавтор: Техноавтор 
включить: включена включить включенным включил включим Включить 
разработать: разработанные разработать разработал разработан разработали разработанных 
репозиторий: репозитории репозиторию репозиторий репозиториев репозиториями репозитория 
знакомство: знакомств 
ползание: ползания 
статус: статус статуса 
появление: появление появления 
управлять: управлять управляют управляет управляющие 
дым: дым дыма Дым 
собес: собеса собес собесы 
стажёр: стажеры стажера стажеров 
натуральный: натуральном натуральным натуральный натурального 
связка: связки 
чувствовать: чувствует чувствуют чувствовал чувствовать 
закручивание: закручивание 
знак: знаки знаке знака знаков знаком 
много: много 
подготовить: подготовил подготовим 
опция: опция опции опцией опцию 
неплохой: неплохих неплохие 
ставка: ставку ставки 
грудь: груди 
эрнест: Эрнест 
живой: живым живыми живая живых живые живое живого 
шифровать: шифрует 
качество: качеством качества качество качестве 
красный: Красный красный Красного красных Красная красного красная 
схема: схема Схема схем схеме схемами схемы схему 
медицина: медицине медицины 
скопировать: Скопировать скопировали 
шаблон: шаблонами шаблона шаблоны шаблон шаблонов Шаблон 
добавление: Добавление добавлением добавления 
автоматизация: автоматизацией Автоматизация автоматизацию автоматизация автоматизации 
завершить: завершили завершит 
пропорционально: пропорционально 
версия: версиями версией версии версий версиях версию версия 
постоянный: Постоянное постоянным постоянной постоянного постоянное Постоянные постоянный постоянные 
пить: пить пьют 
генерировать: генерируют генерировали генерирующих генерировать генерирует 
делать: делай делаете делает делать делаем делают Делает делаешь Делаем делал 
прикусываться: прикусывается 
пусть: Пусть 
захардкожжеными: захардкожжеными 
описать: описал описанную описать описали описанных описанный описан описанные описаны 
дефект: дефекты дефектов дефект 
увеличиться: увеличилось увеличился 
применяться: применяются применяться применяется применялась применялось 
процесс: процесса процессе процессом процессы процессу процессах процесс процессам процессов процессами 
участвовать: участвовало участвует участвующих Участвовали участвуют 
такой: такие таким Таким такой Такие такая Такой таких таком такое такую такими такого Такое 
оранжевый: оранжевый оранжевая 
ранний: раньше Раньше ранних 
адаптер: адаптер 
тот: ту той тому тех те та того Та том тот Те 
объявить: объявил 
пайплайн: пайплайн 
голосовой: голосовое голосовые голосовой 
реально: реально 
незначительно: незначительно 
выпивать: выпивают 
задание: задания задание 
встречаться: встречаются встречались встречаемся встречается встречающийся Встречались 
крупный: крупных Крупнейший крупнейшие крупнейших крупнейшую Крупные крупный крупнейший Крупнейшее крупнейшая 
разный: разные разных разной разными разное разному разная разного разным 
навсегда: навсегда 
добавить: добавим добавили добавить добавила Добавить добавит добавленное добавлен Добавим 
пропускной: пропускной пропускную 
рассказать: Расскажу расскажу рассказал расскажем Расскажите рассказать рассказала расскажет рассказали рассказано 
стучаться: стучится 
начальный: начальным начальную 
ибс: ИБС 
разработка: Разработка разработкой разработки разработке разработка разработку 
язык: языка языков языке языки Язык языку языкам Языком языках язык 
авито: Авито 
тс: ТС 
поддержать: поддержать Поддержу 
бегать: бегать 
математика: математике математики 
просмотрщик: просмотрщик 
выбор: выборе выбора Выбор выбору выбор 
размер: размером размера размеру Размер размеры размер 
мечта: Мечта 
вмешательство: вмешательства вмешательство 
кремниевый: Кремниевой кремниевые 
архив: архивы архива архиве Архив архив архивов 
кэшировать: кэширует 
громкий: громких 
руководитель: Руководитель руководителя руководитель 
ограничение: ограничения ограничениями ограничение 
сверять: сверяют 
дать: дал данная данной дадим данные дали Данные дать Дайте даны Данная 
пользоваться: пользоваться пользовался пользуются 
огромный: огромные огромный огромному огромных 
удаление: удаление Удаление удалению удаления 
очаг: очаг очаги очагов 
явный: явные 
счётчик: счетчик 
дочерний: дочерней дочерних дочерними 
отмена: отмена 
гигиена: гигиену гигиене Гигиена гигиеной гигиены гигиена 
зуб: зубов Зубы зубах зубами зуба зубы зуб зубам 
нотация: нотацию 
сборщик: сборщиком сборщика сборщиков сборщиках сборщики Сборщик сборщик 
обнаружить: обнаружил обнаружила обнаружить обнаружены обнаружили 
стационарный: стационарного стационарное 
статический: статические статическом статический Статический статического статическим 
форматировать: форматировать 
поместиться: поместятся 
понятие: понятием понятие понятий понятия 
взглянуть: Взглянем 
этот: этому этих этой Эти эта этот Эта эти этими Этот эту 
создавать: создавал создаваемые создает создаваемых создавать создаете создавая 
грамотный: грамотным грамотной 
назначить: назначить 
непосредственный: непосредственное 
объект: объекту объектам объекты объектов объект объекта объектами объектом 
зависимость: зависимости зависимость зависимостью 
мочь: можем можете можешь могу мог может Можете Может могла могут могли 
интерпретировать: интерпретируемыми интерпретируемых интерпретируемый интерпретируемого 
относиться: относятся относится относилась 
чип: чипом чипы чипов чипа чипами чип 
кварк: кварками кварка кварков 
драконий: драконьих 
этаж: этажа 
простор: просторах простор просторам 
инженер: инженер инженера инженеров 
именной: именные 
добрый: добрую Добрый Доброго 
опенсорсные: опенсорсные 
эфир: эфире 
урокито: урокиТо 
блог: блога блоге Блог 
вич: ВИЧ 
массовый: массовой 
инициал: инициалов 
являться: являться являются является являющаяся 
развитие: Развитие развития развитием развитии развитие развитию 
карман: карманах карманы карманов 
читать: читать Читать читайте читают Читают 
экономить: экономить 
кривой: кривым 
проиллюстрировать: Проиллюстрировать 
опыт: опытом опыту опыте опыта опыт 
необходимый: необходимом необходимыми необходимая необходимые необходимых необходимое необходимый необходимой 
унифицировать: унифицирована 
сотовый: сотовую 
срабатывание: срабатывания срабатываний 
незабвенный: незабвенного 
дополнительный: дополнительную дополнительные дополнительный дополнительным дополнительных 
зубовпотемнение: зубовпотемнение 
проверять: проверял проверяет проверяют 
виток: витки 
объединяться: объединяться объединяются 
сниппеты: сниппеты 
весна: весна Весна весне 
предустанавливает: предустанавливает 
правовой: правовое 
существенно: существенно 
ментор: Ментор менторов ментор ментора 
замкнуться: замкнется 
отделение: отделений 
мышь: мыши 
бюджетный: бюджетных бюджетному бюджетном бюджетный 
класс: классу класса классам классы класс классов Классы 
научпоп: Научпоп 
успешность: успешность 
сэдс: СЭДС 
пример: примере примеру Пример примеры примерам пример примеров примера примерами примерах 
похоже: похоже 
архитектура: архитектуре архитектурой архитектур архитектуру архитектуры 
симметрия: симметрии 
самоуправление: самоуправления 
экономика: экономики Экономики 
заболевание: заболеваний заболеваниям заболевания 
образоваться: образующихся образуется образуются 
любой: любом любую любые Любой Любые любой любого любых 
заявление: заявлениям заявления 
возврат: возврата возврат 
вчера: вчера 
премия: премию премии 
мощность: мощности 
от: От от 
несовместимый: несовместима 
попасться: попался попавшуюся 
параметр: параметру параметра параметры параметр параметров 
бесплатный: бесплатный бесплатная бесплатные бесплатных бесплатную 
устроенный: устроен 
экосистема: экосистеме экосистемы Экосистема экосистему 
инсталляция: инсталляций инсталляции инсталляциях 
придумывать: придумывать 
рот: рот рта рту 
видеофиксация: видеофиксации 
объединить: объединили объединила объединить 
формироваться: формируются Формируются 
пользовательский: Пользовательская пользовательский пользовательского пользовательской 
текстовый: текстового текстовой текстовые текстовый 
видео: видео 
находить: находить находят находили находит 
англоязычный: англоязычным англоязычных 
совет: советы совета советов 
назначение: назначения назначению назначение Назначение 
представитель: представителями представитель представители 
анатолий: Анатолий 
разбираться: разбираешься разбираюсь разбираться 
задать: заданной заданы заданных заданными задаст заданную задан задать 
насыщение: насыщения насыщение 
чай: чая Чай чай 
отопление: отопления отоплением 
чувствительный: чувствительной чувствительный чувствительными чувствительные чувствительных 
хигерович: Хигерович 
проверяться: Проверяется 
брокер: брокер брокеры брокерами брокеров 
производная: производных 
компонент: компоненты компонент компонента компонентами компонентов компонентом 
относительный: относительной относительная 
технология: технологиях Технологии Технология технологией технологий технологиями технологии технология технологию 
теория: теории теорию теорией 
сниппетов: сниппетов 
приоритетность: приоритетности 
хакатоны: хакатоны 
сокращать: сокращать сокращает 
основа: основе основой Основа 
телетайп: телетайп 
внутренний: внутреннего внутреннюю внутренними внутренней внутренняя внутренних 
горе: горем 
заметить: заметить заметим Заметим заметили заметил 
сгенерировать: сгенерировал сгенерируем сгенерированный сгенерированного сгенерирован сгенерировано 
чтиво: чтиво 
млечный: Млечного 
предупреждать: предупреждали предупреждаем 
слой: слой 
санитизации: санитизации 
деньга: деньги денег 
кстати: Кстати кстати 
девять: девять 
уступать: уступающий 
множество: множестве множества множеством множество 
упомянуть: упомянул упомянуты упомянутое упомянуть 
холодильный: холодильные 
коммерческий: коммерческая коммерческих коммерческого коммерческой коммерческие 
тинькофф: Тинькофф 
ставить: ставьте ставить ставят 
вектор: векторами векторов вектора вектор вектором 
евросоюз: Евросоюз Евросоюза 
ухудшать: ухудшающее ухудшают ухудшает 
модуль: модулем модули модулями Модуль модуля модулей модуль 
процедура: процедура процедур процедуру процедурой процедуры 
тепломонитор: ТеплоМонитор Тепломонитор 
прошлое: прошлого прошлое 
открывать: открывает Открываем 
точка: точки точке точка точках точку точкой точек 
модель: модель Модель моделями моделей модели моделях 
таблица: таблиц таблице Таблица таблицу таблица таблицы 
информация: Информацию Информация информации информацией информация информацию 
видеть: видел Вижу видели видит видим видеть 
овал: овалами 
парный: парный 
парадокс: парадокс 
часть: части Часть частей часть частью 
продьюсером: продьюсером 
судить: Судя судя 
печать: печати 
некоторый: некоторой Некоторых некоторых Некоторое некоторые некоторую Некоторые некоторый некоторого 
оставить: оставить оставит оставило оставив оставим оставлены 
имя: именем имена имени имя имен именам именами 
отображаться: отображается 
набирать: набирает набирал 
автонумерации: автонумерации 
же: же 
регион: регионами региона регионов регионы регионах регион 
местный: местное 
главное: Главное главное главного 
отбеливание: отбеливания отбеливанием отбеливание 
обойти: обойти 
усилие: усилий усилиями 
понадобитсясервер: понадобитсясервер 
потребление: потребления потреблением потребление 
исходный: исходным исходный Исходные исходные исходной исходного исходных Исходная исходная исходном 
прототипный: Прототипно 
кондиционер: кондиционерами 
автоматизациидоклад: автоматизацииДоклад 
сэд: СЭД 
отдельный: отдельную Отдельная отдельных отдельный отдельные 
обмануть: обмануть 
французский: французские 
удалить: удалить удалит удалено 
последствие: последствия последствий 
постдня: постдня 
особый: особое особую особый особых особого 
дц: ДЦ 
сегментация: сегментации сегментация 
специфицировать: специфицировать 
плоский: плоские плоского плоской 
планироваться: планируется 
шов: швов 
элементарно: элементарно 
рейтинг: рейтинге рейтингу рейтинга Рейтинг 
эксплуатационный: эксплуатационной 
практически: практически 
пациент: пациенту пациентами пациентах пациенты пациентов пациента пациентам пациент 
аудитория: аудитории аудиторией аудитория 
блокчейн: блокчейн Блокчейн 
заинтересовать: заинтересовать Заинтересовавшие 
скачать: скачать 
нерациональный: нерационального нерациональный нерациональным нерациональных 
производительность: производительность производительности 
выйти: выйдем вышла вышел выйти 
коллекция: коллекций коллекция коллекции Коллекция Коллекции коллекцию 
резидент: резиденты 
органический: органический органических органического 
игровой: игровых игровой игрового игровые 
позвать: позвали 
рябиков: Рябиков 
искажение: искажение 
вдыхать: вдыхаемого 
кредит: кредитов 
браузер: браузере 
знать: знать знают знаете Знай знали знает Зная знаю 
лут: лут 
рабочий: рабочего рабочий рабочем рабочим рабочей Рабочий 
решение: решения решении решение решениях решениями решений решением 
последовательный: последовательных последовательные 
точность: Точность точности 
останавливать: останавливала останавливать 
воспользоваться: воспользоваться 
надлежащий: надлежащую 
речь: речь Речь 
прогноз: прогнозы прогноз 
загружать: загружает 
пригласить: пригласить Приглашена Приглашен Пригласил 
собственный: собственную собственным собственными собственный собственного собственные собственное собственной собственном 
буква: букОв буквы буквами 
название: названия названием название Название названий названии названиях 
сравнение: сравнению сравнения сравнении Сравнение 
разговаривать: разговаривайте 
нейтрон: нейтрон нейтрона нейтроны 
боевой: боевых боевые 
разбойник: разбойника 
другой: Другой другие другим других Другим Другие Другое другую другая другой другое другими Другими другого 
подписчик: Подписчики 
рассказ: рассказ 
контейнер: контейнеру контейнере контейнерам контейнеров контейнерами контейнера контейнер контейнеры контейнером 
топика: топик топика 
критически: критически 
государственный: государственные Государственной государственного государственных 
демонстрационный: демонстрационном 
пакет: пакеты пакете пакет пакетов пакета 
телескоп: телескоп 
пост: посты посте пост 
мотиватор: мотиватор 
универсальный: универсальных универсального универсальную 
десна: десны десну десна 
плоскость: плоскость Плоскость плоскостью плоскости 
комментарий: комментарий комментарии комментариев Комментарии комментариях Комментарий комментария 
преимущество: Преимущества преимущества преимуществами преимуществ преимуществом 
значит: значит 
менять: меняет Меняем меняем меняя менять 
честно: честно 
член: членов членами члена 
обратно: обратно 
предписание: предписания 
больница: больнице больницах больниц Больницы 
полоска: полоски 
бинарник: бинарник 
кодогенерацию: кодогенерацию 
отслеживание: отслеживания отслеживанию отслеживание Отслеживание 
нажатие: нажатий нажатия 
событие: события событиях событий событие событиями События 
биржа: бирже 
совместный: совместную совместной совместная 
мрт: МРТ 
опять: опять Опять 
замыкаться: замыкаться замыкается 
восприниматься: восприниматься воспринимается 
вовлечение: вовлечение 
курящий: курящему курящего курящих курящие 
причина: Причин Причины причиной причине причин причинам причины причина причину 
произвольный: произвольной произвольном 
сползать: сползать 
создание: созданию создании создания созданием Создание создание 
пускай: пускай 
отмечаться: отмечалось 
отслеживать: отслеживает 
плагин: Плагин плагинами плагин 
машинаисточникмного: машинаИсточникМного 
избежать: избежать 
уметь: уметь умеют умеет 
опенсорсный: опенсорсный 
над: над 
маленький: меньше маленьких маленьком 
результирующий: результирующей результирующего 
премиальный: премиальная премиальный 
определимый: определим 
потрясать: потрясающая 
разобрать: разобрать разберем 
станислав: Станислав 
полнофункциональных: полнофункциональных 
нажать: нажать нажав 
собеседование: собеседования собеседовании 
разнообразный: разнообразными разнообразные 
оба: оба Оба обоих обеих 
проглядываться: проглядывается 
выписать: выписанных 
деятельность: деятельностью 
централизовать: централизованным централизованное централизованных 
попадание: попадание 
близкий: близких ближайшем близкую 
уязвимый: уязвимым уязвимая уязвимых уязвимо уязвимый уязвимы уязвимые уязвимую 
учитывать: учитывая Учитывая учитывать 
сфера: сфере сферу 
обыскать: обыскав 
особенно: Особенно особенно 
обработка: обработку обработке обработка обработки Обработка 
томография: томографии 
соглашение: Соглашение соглашение 
полезный: полезную полезные полезной полезная Полезные Полезное полезными полезного 
ярмарка: ярмарки ярмарках ярмарке 
видеоконференция: видеоконференции 
человек: люди людей Человек человеком человеку человек людьми человека людям 
одежда: одежде 
ориентировать: ориентированный ориентированное ориентированным ориентированного ориентирован 
минеральный: минеральной 
который: которое которому которыми которые которым которая Которые которого который которых которой котором которую 
никита: Никиты Никита 
остановка: остановка 
первоначальный: первоначальным первоначальном 
тем: Тем тем 
соприкасаться: соприкасающейся соприкасаются 
перед: перед 
имплантат: имплантатами имплантатов имплантат имплантата 
национальный: Национального Национальным Национальная 
ящик: ящик 
доступ: доступом доступ Доступ доступа доступе 
круг: круга круг 
атом: атом атомах атомы атома атоме атомов атомами 
никакой: никаких никакое никакого никакой 
подключение: подключений подключении подключения подключение подключениях 
стандарт: стандартами стандарт стандарты стандарта стандартом стандартам стандартов 
осмыслить: Осмысленные 
доступный: доступен доступна доступном доступны доступными доступный доступная доступной доступные 
строгий: строгие строгого строгой строгое Строгая строгим строгую Строгую строгом 
куратор: Кураторы 
штат: штатов штата 
миф: мифы 
тенденция: тенденцию тенденциями тенденция тенденций тенденции 
менторствонаставничестворазвитиеджуныстажеры: менторствонаставничестворазвитиеджуныстажеры 
связываться: связывается связываться 
адрес: адресов адрес адреса адресом адресу 
приближаться: приближаемся 
неочевидный: Неочевидные неочевидные 
определённый: определенному определенные определенный определенном определенную 
температура: температур температуры температуре температуру температурой 
онбординг: онбординг 
поздно: поздно 
базовый: Базовое Базовыми базовой базовые Базовая Базовый базового Базового базовую 
ложный: ложных ложные 
разбивка: разбивку 
япония: Японии 
положение: положение 
думать: думающие Думаем думать 
флант: Флант 
анна: Анна 
метод: методами методы Методы метод методов 
лекарство: лекарствах лекарством лекарств 
бывать: Бывают бывает бывают Бывает 
состояние: состоянии состоянием состояние состояния 
маршрутизатор: маршрутизаторы 
конечность: конечностей 
уравнение: уравнение уравнений уравнения 
срок: срока срок Срок сроков сроки 
построить: построить построенную 
флаг: флага флаг Флаг 
ручной: ручное ручной ручном ручного Ручной ручная 
коммутация: коммутацию 
вы: вами Вы вам вас Вас вы Вам 
через: Через через 
рамка: рамками рамках 
показать: показан показали Покажем показано показало показал Показать показать 
небезызвестный: небезызвестной 
парадигма: парадигмы парадигму 
пётр: Петр 
затрата: затратах затратам затрат затраты 
сигаретный: Сигаретный сигаретный сигаретного 
приводить: приводить приводящая приводит 
включать: включающая включать включаем включали включают включает 
радуга: Радуга радуга 
испания: Испании 
курс: курс курсе курсов Курсы курсом 
ориентировочно: Ориентировочно 
дело: делам дело дела делом деле 
гонять: гоняет 
сложить: сложить 
менторства: менторства 
цвет: цвета цвет цветом 
конечный: конечным конечного конечный 
пульт: пульт 
новость: новость новости Новости новостей 
устройство: устройство устройстве устройству устройством устройствам устройствах Устройства устройства Устройство устройствами устройств 
знаменатель: знаменатель знаменателей знаменателя 
отнести: отнести 
истечь: истек 
удовлетворение: удовлетворение 
техподдержка: техподдержка техподдержке 
стоить: Стоит стоит 
орган: органов органы 
реминерализации: реминерализации 
случай: случаев случаями случае случай случаи случаях 
шаг: Шаг шагах шаг шаге шагов 
втб: ВТБ 
взрослый: взрослых 
биометрический: биометрические биометрических биометрической биометрического биометрическими 
фреймворк: фреймворков фреймворк фреймворки 
атрофия: атрофии атрофией атрофия атрофию 
железо: железо железом 
спрос: Спрос спроса 
включая: включая 
уровневый: уровневого уровневому уровневые Уровневые уровневыми уровневый уровневых 
ожидать: ожидаемо ожидаемая Ожидают Ожидает Ожидаемое ожидать ожидали 
зарплата: зарплатой зарплаты 
вычистить: вычистит вычистить 
большой: побольше большого больше Больше большое большой 
протон: протонами протонов протона протоны протон Протоны 
противоречащий: противоречащие противоречащий 
она: ней Она ее она ей Ее нее 
изучаться: Изучаются изучаются изучается 
савунов: Савунов 
действовать: действует действующего действовать действуют действующим 
относительно: относительно Относительно 
подразумевать: подразумевает 
скат: СКАТ 
иногда: иногда Иногда 
вспомогательный: вспомогательный вспомогательными 
кусочный: кусочную 
фильтровать: фильтровать 
предположим: Предположим 
лута: лута 
ввести: ввели ввести 
видеоконференцсвязи: видеоконференцсвязи 
органика: органика 
так: Так так 
формально: Формально формально 
церна: ЦЕРНа 
хостинг: хостинг 
притом: Притом 
итог: итог ИТОГ итоги Итоги итоге 
эмиссионный: эмиссионной 
забывать: забывайте забываем забывать 
отправить: отправлено 
листок: листок 
переконфигурирование: переконфигурирования 
последний: Последние последние Последнее последней последнюю последний последних последнего последнему Последний 
контент: контент контента Контент 
ограничить: ограничено ограничена 
выполнить: выполнить выполненных выполнена выполните выполнены выполнено 
извлечь: Извлеченные 
пульсар: пульсаров пульсары 
данный: Данный данного данный данную данном 
профессиональный: Профессиональные профессиональная профессиональную профессиональной Профессиональное 
шутка: шутка 
грабли: граблям 
целевой: Целевая 
увеличиваться: увеличивается 
паста: пасты паста паст пастой 
локальный: локальная локальных локальный локальные локальной локальное локального 
теперь: теперь Теперь 
бюджет: бюджеты бюджетов 
игра: игр игре игра игры играм Игры Игра 
сказать: сказали сказать Скажу сказанного сказал скажу сказала сказано скажет 
понимание: пониманию Понимание понимание понимания 
обзорный: обзорной 
третий: третьей третье третьих третьего Третий третьем 
вендор: вендором вендорами вендоры вендоров 
дедуплицировать: дедуплицировать 
копирайтерам: копирайтерам 
взятие: взятии взятия 
направить: направленный направлю 
привет: привет Привет 
вдруг: вдруг Вдруг 
недостаток: недостатки недостаток недостатков недостатка 
проваливаться: проваливается 
версионирование: версионирование 
федеральный: федеральным 
месяц: месяца Месяц месяцев месяц 
кислота: кислот кислота 
пропиленгликоль: пропиленгликоля 
байт: байт байта 
сдампленные: Сдампленные 
предназначить: предназначены предназначенные предназначенной предназначенный 
рациональный: рациональной рациональных рациональном рационального рациональный 
нежелательный: нежелательные нежелателен 
стражник: стражников 
зелёный: зеленом зеленая Зеленые Зеленый 
получиться: получившийся получится получилось получиться получился получилась 
колдун: колдун колдунов колдуна 
копия: копий 
раздел: раздел Разделы 
называть: называемой называть называют называемая называемыми называемые называемых называем 
полтора: полтора полторы полутора 
максимально: максимально 
обновлять: обновлять 
антипротон: антипротоны антипротоном 
перьевой: перьевой 
условиться: условиться 
испортить: испортил испортить 
становиться: становится становилось становятся 
анонимизация: анонимизация Анонимизация 
фон: фоне 
перспектива: перспективе перспективу 
аудиофайл: аудиофайлы 
проход: проход 
сначала: Сначала сначала 
проектирование: проектирования Проектирование проектированию 
заполнить: заполнил заполнены заполнен заполнить 
хабраавторов: хабраавторов 
системустройство: системУстройство 
июнь: июня 
максимальный: Максимальное максимальное Максимальная 
доклад: докладами докладе доклады докладом доклад доклада 
обеспечение: обеспечения обеспечение обеспечении обеспечению Обеспечение 
сэддействительно: СЭДДействительно 
помещаться: помещается помещаются 
конфигурация: конфигурации конфигурацию 
примитивный: примитивными Примитивных примитивные примитивного 
я: Меня Мне мне меня 
развивать: развивают развивать 
гештальт: гештальтов 
отдирать: отдирать 
атаковать: атакующие атакуемом 
назад: назад Назад 
защита: защиты защите Защита защиту защита 
раковый: раковых раковая 
вкладка: вкладки вкладку вкладка вкладок вкладке 
челлендж: Челлендж 
аутентификация: аутентификации аутентификацию 
клиника: клиники клиник клинике клинику 
конфиденциальный: конфиденциальную 
профилактика: профилактики профилактика профилактику профилактике 
контроль: контроля контролем контроль контролю 
представить: представил представить представлены представленным представлен 
излишний: излишней 
мировой: мировой мировые мировым 
датчик: датчика датчик датчиков датчиками 
сопротивление: сопротивление 
прописать: прописанной 
фаза: фаза фазу 
проникновение: проникновение проникновения проникновений 
два: двумя два Два две двух Две 
частный: частной частный частными частных 
парето: Парето 
разновидность: Разновидностей 
черепенников: Черепенников 
потенциальный: потенциального потенциальных потенциальные потенциальными потенциальным потенциальный 
риск: рисков риск риском риска риски рисками 
подробный: подробное подробнее Подробный Подробное Подробнее Поподробнее поподробнее подробные подробным 
состоять: Состоит состоящие состояла состоящую состоит состоят 
помещение: помещением 
подделка: подделку 
эльбрус: Эльбрус 
солнце: солнце Солнце 
гарантировать: гарантировать гарантирует 
стандартный: стандартная стандартным стандартный Стандартной стандартные 
предыдущий: предыдущий предыдущие предыдущего Предыдущие предыдущему предыдущих 
случиться: случилось 
определяться: определяются определяется 
данные: данных данными данным 
независимый: независимых Независимый 
ощущение: ощущениям ощущение 
компьютерыстарое: компьютерыСтарое 
про: про Про 
совместимый: совместимых 
известный: известная известном известному известными известные 
талантливый: талантливых талантливыми 
ханова: Ханова 
сгладить: сгладить 
сплайн: сплайн сплайном сплайна сплайнов сплайны 
порт: порт порты порту 
сценарный: сценарного 
диаграмма: диаграмма диаграмм диаграммы диаграмме диаграмму 
геномики: геномики 
намерить: намерены 
низкоуровневый: низкоуровневого низкоуровневый низкоуровневых 
признак: признаков признак 
стремиться: стремится стремился стремясь 
скелетный: скелетно Скелетно 
увеличение: увеличение увеличения увеличению 
ввод: ввод ввода 
сбер: Сбер 
хард: хард 
ложиться: ложиться 
потреблять: потребляет потребляемой потребляют 
графически: Графически графически 
появиться: появится появились появилась появившемся появилось Появится появился 
формировать: формирует формирующих формировать 
цифровой: Цифровой цифровой цифровых Цифровые цифровое 
воздействовать: воздействует воздействовать 
шина: шину шиной шине шина 
занимать: занимать занимаемого занимает занимала занимают занимал 
до: до До 
тз: ТЗ 
кафка: кафке Кафка 
аппы: аппы 
рак: рак рака раком 
размечать: размечать Размечаем размечали 
придумать: придумали придумано придумать 
администрирование: администрирование Администрирование 
соблюдение: соблюдение соблюдения 
продолжать: продолжайте продолжать продолжаем 
удовлетворять: удовлетворяет 
весомый: весомый 
красавица: красавице 
ядро: ядер ядро ядре ядра 
базисный: базисные базисных 
пиркс: Пиркс 
исходящий: исходящее 
знакомый: знакомые 
понятно: Понятно понятно 
набор: Набор набор набора 
подкоманда: подкоманду 
распад: распаде распада 
кандидат: кандидата кандидатов кандидат 
продлевать: продлевающий продлеваемого продлеваемой продлеваемом продлевать 
вызвать: вызвать вызовем вызвано 
периодический: периодической 
отражать: отражает 
обязать: обязан обязаны обязал 
радиус: радиусу радиус 
популярный: популярное Популярные популярная популярные популярную 
экстремум: экстремумами 
сторонний: сторонней стороннее сторонним Сторонним 
предотвращать: предотвращать 
цель: цели целей целях Цель цель Цели 
утвердить: утвержденного 
прошлый: прошлых прошлый прошлом 
надёжный: надежнее надежны надежную 
табачный: табачные Табачный 
составление: составлением составление составлении составления 
основываться: основываясь 
иллюстрировать: иллюстрировать 
снеготайки: снеготайки 
кодогенерация: кодогенерация 
распространить: распространенный распространено распространенные распространенной 
готовый: готового готовы готов готовые готовый готовую готовых 
поколение: поколения 
шесть: шесть 
уехать: уехал 
метрический: метрическую метрическом 
летний: летняя 
верный: верен верное Вернее 
превышать: превышать 
многое: многом многого многое 
выводить: выводить Выводить 
небольшой: небольшой небольших небольшие Небольшое 
август: августа 
поль: Поль 
писатель: писателями писатель писателей писатели писателям 
ороговевает: ороговевает 
как: Как как 
полторака: Полторака 
курить: курите Курить курил курить курят курю курит Курите 
сбор: сбор Сбор сбора сборе 
сортировка: Сортировка 
самолёт: самолет 
похожий: похожи похожее похожие Похожие 
прислать: пришли 
снижение: снижении снижения снижение Снижение снижением 
трассировка: трассировке 
содержать: содержащую содержащий содержат содержать содержащие содержит 
задумка: задумок 
большинство: большинства Большинство большинство большинстве 
личный: Личный личной личный личная личному личных личные 
телефон: телефоны телефона телефонах 
нужнонужносоздание: нужнонужносоздание 
издержка: издержки издержек 
стоматологияклиникакурениезубы: стоматологияклиникакурениезубы 
провайдер: провайдера провайдеров 
сообщить: сообщил 
нужно: Нужно нужно 
новичок: Новички Новичок новичком новичка новичками новичков новички новичку 
сегодня: сегодня Сегодня 
бояться: Боятся боятся бояться 
внимательный: Внимательный 
голосование: голосование 
транзитивный: транзитивные 
писать: пишете пишут Пишем пишем писать писали пишет писал 
радугаздоровьенаучно: РадугаЗдоровьеНаучно 
дискета: дискеты 
жидкость: жидкостью жидкости 
исследовательский: Исследовательские исследовательских исследовательским исследовательского исследовательской 
объяснить: объяснена объясни объяснить 
ухудшаться: ухудшаться 
токен: токен 
старательный: старательного 
скачивание: скачивания скачиванию 
разметка: Разметка разметки разметку 
отросток: отростки 
оказаться: окажется оказаться оказался Оказалось оказались 
раскрывать: раскрывать 
токсичный: токсичных токсичного токсично 
установить: установили установленном установить Установить установлен установим 
панацея: панацея 
айсберг: айсберга 
сопровождение: сопровождении сопровождения сопровождением сопровождение Сопровождение 
контролировать: контролировать контролируемый контролируют 
вложить: вложенных 
интеграция: интеграция интеграции Интеграция интеграцию 
читатель: читателей читатель читатели читателя 
программист: программистом программистам программист Программист 
выпустить: выпустила выпустило выпущен выпустили 
лицензия: лицензии лицензия лицензию 
аналитика: Аналитика аналитика 
замечание: замечание замечаниями 
модерация: модерацию 
болезнь: болезни 
выгрузка: выгрузку 
польгун: Польгун 
освободиться: освободиться освободившуюся 
реальный: реальные реальной реальная реальное реального реальных Реальная реальный 
поделиться: поделится поделиться поделился поделюсь поделились 
смещение: смещением 
посещаемость: посещаемости 
неуловимый: неуловима 
восстановление: восстановления восстановлению восстановление 
картина: картину 
жёлтый: Желтый 
одинаковый: одинаковые одинаковым одинакового 
техника: техник техники техникой 
радиатор: радиаторов радиаторами 
оный: оных 
возникновение: возникновения возникновению 
регулирование: регулирования 
датасетами: датасетами 
продьюсера: продьюсера 
кипяток: кипяток 
состав: состав 
выключать: выключать 
гусейн: Гусейн Гусейна 
хитрость: хитрость Хитрости 
аналог: аналогов аналог 
лицо: лиц лица лицо лицам лицу 
солар: Солар 
сауна: сауной 
сделать: Сделай сделать сделан сделаны сделали сделано сделанное сделает Сделать сделал сделаем 
полиция: полиции 
блокировщик: блокировщик 
ребята: ребятами Ребята ребятам ребят ребята 
исключать: исключать 
перевод: переводов Перевод перевод 
применение: применения применению применение 
занятый: занят 
потенциально: Потенциально 
слово: словах словами слова слов 
поле: поле поля 
достаточный: достаточного достаточный достаточное 
счёт: счет счетов 
топ: ТОП ТОПе топе Топ 
утечь: утечь утек 
пройти: прошла пройти 
приносить: приносит приносить 
должный: Должно должен должна должно должны 
подсумок: подсумки 
частица: частицу частица частиц частицы частицами 
фича: фич фичи 
драйвер: драйвер 
применимый: применим применимых применимы 
бот: бота боты 
условие: условия условиям Условия условии условий условиях 
зубной: зубные зубными зубной зубного зубных зубную 
спринт: спринт 
нести: несут несет 
перечень: перечень перечни перечня перечнем 
виет: Виет 
выпечка: выпечкой 
привлечь: привлекла привлекли привлек 
линден: Линден 
пока: пока Пока 
агентство: агентства агентство 
замкнутый: замкнутой замкнутыми замкнутых 
случаться: случались случается 
сеть: сети сетей Сети сеть сетях 
пролетать: пролетает 
переадресовать: переадресовать 
обрабатывать: обрабатываем обрабатывает 
говорить: говорим говорил говорить говорит говоря говорят говорили говорите 
хватать: хватать хватает 
сравнительно: сравнительно 
самый: самый самая самыми Самый самых Самое самую Самая самым самые самое 
хирург: хирурга хирургов 
программа: программ программы программа Программа 
авто: авто 
остановиться: остановимся остановились остановится 
исходить: исходя исходят Исходя 
супердоходов: супердоходов 
хаос: хаоса 
но: Но но НО 
кратер: кратера 
компиляторыненормальное: КомпиляторыНенормальное 
выпускать: выпускает выпускаемые 
команда: командой команды командами Команда команду команд команда команде 
доказательство: доказательство 
потому: потому Потому 
дёшево: дешево 
конец: конца концов концами конце 
ортодонтический: ортодонтическое 
сишные: сишные 
роман: романе Роман 
частый: почаще Частый чаще частое 
сниматься: снимаются снимался 
программатор: программаторе программатором Программатор 
сухость: сухость 
граница: границ границах Границы граница 
против: Против против 
сыграть: сыграли 
нижний: нижнем нижняя нижний нижней 
вышка: вышками 
грант: грант 
странный: странная странных странного странный Странная 
выдерживать: выдерживающим выдерживает выдерживают 
светодиодный: светодиодным 
подготовка: подготовка подготовке Подготовка 
делиться: делятся Делимся делиться делящегося делится 
роба: робу 
помощь: помощи помощь помощью 
благодаря: Благодаря благодаря 
табак: табака 
коммуникация: коммуникация коммуникации коммуникаций 
диапазон: диапазон диапазона 
иммунный: иммунный 
находиться: находились находятся находится Находящиеся 
отображение: отображение Отображение 
клык: клык клыке 
презентация: презентаций 
целенаправленный: целенаправленной 
финансовый: финансовых финансового финансовым финансовой 
предстоять: предстоит 
момент: моменты момент моментов моментом моменте момента 
подставить: Подставив 
запоминать: запоминающее запоминающие 
накопиться: накопившийся 
облачный: облачными облачных Облачная облачную облачный облачного 
сравнить: сравните сравнить 
каскад: каскадом 
повышение: повышению повышение повышении повышения Повышение 
упустить: упустить 
стесняться: стесняюсь стесняется стесняются стесняться 
очки: очки 
технологический: технологические технологических технологического технологическую 
инвентарь: инвентаря 
котлы: котлами 
управление: управлении управлению Управление управления управление управлением 
каждый: каждый каждом каждую каждая каждым Каждый каждые каждой Каждое каждому каждого 
оригинально: оригинально 
загрузка: загрузку загрузке 
стёклышко: стеклышка 
инструментызаключениев: инструментыЗаключениеВ 
возвратиться: Возвратимся 
впечатляющий: впечатляющей 
темнеть: темнела темнеет темнеть 
анестезия: анестезии 
видюха: видюха 
мнение: мнению Мнение мнение 
капот: капотом 
сотер: Сотер 
участок: участок участке 
отходить: отходить отходит 
вывести: выведет вывести 
москва: Москве Москва 
автоматика: автоматику автоматики 
беспокойствауже: беспокойстваУже 
заказ: Заказы заказа заказ заказов 
гель: гели 
тут: Туту тут Тут 
удалёнка: удаленки 
посетить: посетило 
интерпретироваться: интерпретируется 
самойленко: Самойленко 
противник: противники противник противников 
апрель: апреле апреля 
время: времени время Время временем 
наружу: наружу 
оптимизировать: оптимизированные оптимизировать 
средний: Средний средних 
оригинальный: оригинальный оригинальных 
лежать: лежать лежит лежащих 
параметризовать: параметризованные 
откуда: Откуда откуда 
указатель: указателям указателях 
обсуждать: обсуждают 
внедрение: внедрение внедрения Внедрение 
важно: важно Важно 
проводить: Проводите проводить проводит 
аутентичность: аутентичности аутентичность 
пространство: пространства пространстве 
получаться: получается Получается 
рассказывать: рассказывать рассказывают рассказывали рассказываем Рассказываем 
отдавать: отдавать 
запись: записям запись записи 
обновляться: обновляться обновляется 
эшелон: Эшелон 
устояться: устоялось устоявшиеся 
столяров: Столяров Столярова 
доступомуправлениеит: доступомуправлениеит 
довольный: доволен 
осветительный: осветительные 
форум: форумы форумах форумам 
заказчик: заказчика заказчику Заказчик заказчиком заказчики заказчиками 
опробовать: опробованные 
строка: строку строка строк строки 
именно: именно 
веселие: веселье 
изучать: изучать изучали изучают изучая 
уже: уже 
хаб: Хаб хаб 
происходить: происходила происходит происходящее происходило Происходит происходящего 
провал: провала 
поверхность: поверхности поверхностей поверхность поверхностях 
наделять: наделяют 
документооборот: документооборота 
неизвестно: неизвестно 
критический: критические критических критической 
открыть: открыли откроем Открыть открыть открыт 
переслать: перешли 
видно: Видно видно 
диабет: диабета 
после: После после 
эквидистанту: эквидистанту 
финкельштейн: Финкельштейн 
прочесть: прочесть Прочесть 
кварцевый: кварцевым Кварцевый 
использование: использовании использование использования Использование использованию 
жить: живут живет 
поляк: Поляков 
ггц: ГГц 
классический: классические классических классической 
сдвинуться: сдвинулся 
осветить: осветить 
устанавливать: Устанавливать устанавливать 
гарвардский: Гарвардском 
вызов: вызовов вызовах вызове вызова вызовом вызов 
удалять: удаляют удалять 
развесистый: развесистого 
снять: снять 
значительный: значительных значительной 
хороший: хорош Лучшие хорошему Хороший лучше хорошего хороший хорошее хорошие хороши Лучший лучшее хорошей Хорош лучшая лучшие лучших лучший хороших 
дата: дат даты датами дату дата Дата 
фактически: фактически Фактически 
прибавить: Прибавьте 
минимальный: минимальным минимальными 
основать: основанной основанный основаны основанном основана основан 
окружающий: окружающие окружающий 
классификация: классификации классификация 
космос: космос 
отгружать: отгружать отгружает 
процессор: процессоров процессором процессора процессор 
правило: правилами правил правила правило правилом правилам 
дизмораль: дизмораль 
корректный: корректную 
искренне: искренне 
определение: определения определению определением определение определениями определении 
список: списка список списках списке Список списком списки 
совсем: совсем Совсем 
измерение: измерения измерением измерений Измерение 
альтернатива: альтернатива альтернативы альтернатив альтернативу 
джуна: джунами джунах Джуны джуна 
собираться: собираются собираюсь собираетесь 
идентификация: идентификации 
угроза: угрозы угрозу угроз 
сформулировать: сформулировал 
себя: собой себя себе 
разрекламировать: разрекламирован 
мониторинг: мониторингу мониторинга Мониторинг мониторинг 
возвращать: возвращаем возвращает возвращала 
агрессивный: агрессивной 
проверка: Проверка проверок проверкам проверке проверки проверку проверка 
сфокусироваться: сфокусироваться 
например: например Например 
портал: порталах порталы портал 
еда: еды 
помимо: помимо Помимо 
утверждение: утверждение утверждения 
свести: свести 
ментальный: ментального 
отправлять: отправлять 
пассажир: пассажиров 
вноситься: вносятся 
нуль: нуля нулю 
интоксикация: интоксикации 
чижиумов: Чижиумов 
разместить: размещено разместить 
пригодиться: пригодиться 
датасета: датасета 
защитить: защитить 
вступать: вступает 
недавно: Недавно недавно 
приветственный: приветственную 
плохой: плохи Плох плохую плохие хуже 
контроллер: контроллера контроллер контроллером Контроллер контроллеры контроллеров 
контрагент: контрагентов 
удовольствие: удовольствие Удовольствие 
предсказуемый: предсказуемый 
снизиться: снизилась 
библиотека: библиотека библиотеки библиотеками библиотеках библиотеку библиотек 
лайфхак: Лайфхаки Лайфхак 
восстанавливать: восстанавливаем восстанавливающим восстанавливающие 
сортировать: Сортировать 
просматривать: просматривать 
размещаться: размещаются размещался размещается 
шлем: шлемы 
задержка: задержки 
высокоабразивные: высокоабразивные 
зависнуть: зависнет 
причём: Причем причем 
сканировать: сканировать сканирует 
глэмпинги: Глэмпинги 
изменение: изменение изменении изменения изменений 
бандит: бандитами бандитов 
связь: связи связь 
программирование: программирования программированием Программирование программирование 
вместимость: вместимость 
аннигилировать: аннигилируют аннигилирует 
способность: способность способности способностей 
объяснимый: объяснимо 
отрицать: отрицать 
включение: Включения включения 
персонаж: персонажи персонажу персонажей персонаж персонажа 
профилактический: профилактический профилактическими профилактических профилактические 
поменять: поменять 
лоб: лоб 
прогрев: Прогрев 
расстановка: расстановку 
поведение: Поведение поведения поведение поведении 
астрономия: Астрономия 
переманить: переманить 
мара: мар 
век: века век 
реминерализующим: реминерализующим 
нейросеть: нейросеть 
статья: Статья статье статьи Статьи статья статью 
гигиенический: гигиенических гигиеническая 
компьютер: компьютера компьютер компьютерами компьютеры 
свой: своей своего свой своими Свой свое свою своих своим свои своем своя 
набрать: наберем набрал 
отказаться: отказаться 
пункт: Пункт пунктов пункт пункте пункты 
кредитный: кредитной 
физтехпарке: Физтехпарке 
предплечье: предплечий 
стейт: стейт 
мерлен: Мерлен 
выборка: Выборка 
маркетинг: маркетинг Маркетинг 
лаборатория: лабораторий Лаборатория 
антипротонный: антипротонный 
эмаль: эмали эмалью эмаль 
везде: везде 
план: плане планы планов план 
объём: объеме объема объемов объем объемом объемах 
замылился: замылился 
восстановительный: восстановительные 
центральный: центральным Центральный центрального 
анкетный: анкетными 
программировать: программируя программировать 
заря: заре 
модульный: модульных 
малевать: малюют 
перечисленный: перечисленными перечисленные перечисленных Перечисленные 
технологичность: технологичности Технологичность 
лечебный: Лечебно 
выкуривать: выкуривающих выкуривал выкуриваемых 
вчерашний: вчерашних 
привлекательный: привлекательнее 
кодим: Кодим 
начаться: началась начался 
картограмма: картограмм 
три: Три три трех тремя 
дисбаланс: дисбаланс 
длительность: длительности 
чем: Чем чем 
винт: винт винта 
свойство: свойств свойства 
творческий: творческих 
мюоний: мюоний 
ум: умов ума 
компьютерный: компьютерное Компьютерное компьютерных компьютерным 
подкрепление: подкреплением 
предоставлять: предоставляет предоставляют предоставляющий предоставлять предоставляем 
аналитик: аналитики аналитикам Аналитик аналитиков аналитиками 
братченко: Братченко 
векторовтрехгранника: векторовтрехгранника 
оратор: оратора 
повести: поведем поведут 
менторстве: менторстве 
туториал: Туториал 
прибыль: прибыль 
приобрести: приобретенные 
фрода: фрода 
отнимать: отнимает 
инфраструктураинформационная: инфраструктураинформационная 
лишить: лишит лишить 
заботиться: заботятся 
привычный: привычного привычной привычный 
выгрузить: выгруженные 
заработок: Заработка заработка 
свет: света светом свет 
нарушение: нарушениях нарушения нарушении нарушение 
подписать: Подписан Подписана Подписать подписать 
сверхмассивный: сверхмассивная 
нехватка: нехватки 
оставаться: оставались оставаться остаются остается 
палеонтолог: палеонтологи 
датасетах: датасетах 
продление: продлении Продлением продление продления Продление 
ещё: еще Еще 
подавать: подавать 
кривойк: кривойК 
многоквартирный: многоквартирные 
удерживать: удерживающие 
встроить: встроенный встроить встроенным встроенными 
сервис: сервис Сервис сервисом сервисах Сервисы сервисы сервису сервиса сервисами сервисов сервисе 
любопытный: Любопытные любопытным Любопытный 
бэкап: бэкап 
игорь: Игорь 
уязвимостейуязвимости: уязвимостейуязвимости 
около: ОК около 
кодовый: кодовой 
американский: Американский Американской американский 
вычитывать: вычитывать 
функционировать: функционирует функционируют 
автоматизировать: автоматизирует автоматизировать 
звезда: Звезда звезды 
скворцов: Скворцова 
взяться: взялся 
требоваться: требовалось требуется требуются 
актив: Актив 
результативный: результативным 
резолвер: резолвер 
платформа: платформой платформу платформа платформах Платформа платформ платформы платформе 
регулятор: регулятора Регулятор регуляторы 
обстановка: обстановке обстановка 
оценочный: оценочных 
функционал: функционалу функционал функционала 
окружать: окружает 
отечественный: отечественных отечественный отечественные 
челюстной: челюстной 
узел: узлы Узлы 
частное: частного 
михаил: Михаил 
отчество: отчество отчестве 
наглядность: наглядности 
поддерживать: поддерживает поддерживающего Поддерживайте поддерживают поддерживать поддерживающий поддерживаем 
качественный: качественных качественную качественная качественным качественном 
невотон: НЕВОТОН 
намного: намного 
затем: Затем затем 
различный: различными Различные различным различные различных различная 
добивать: добивают 
полномочие: полномочий 
существовать: существовал Существуют существовать существуют существует Существует существовало 
литературын: литературыН 
переговоры: переговоры 
крутейшая: Крутейшая 
массивный: массивные 
пломба: пломбы 
эффективный: эффективное эффективнее Эффективные эффективную эффективных 
попросить: попросят 
микросервису: микросервису 
номерной: номерные номерном 
изучение: изучении изучения 
ход: ходе 
мультитул: мультитул 
железный: железные 
карта: карт карты карту карта 
продумывать: продумывать 
единственный: единственное Единственное Единственный единственная 
заменять: заменять заменяя 
практиковать: практикуем 
дойти: дойдем 
инцелы: Инцелы 
танец: танцы 
спектр: спектр 
константный: константным константная 
регистр: регистре регистр 
наблюдать: наблюдаем наблюдал 
обеспечиваться: Обеспечивается обеспечивалась 
совпадать: совпадал совпадающее 
нужнонужносамостоятельная: нужнонужносамостоятельная 
вампир: вампира 
печальный: печальном 
экспертиза: экспертизой 
увидеть: увидеть увидим увидите увидел Увидим 
накопить: накопила накопивший 
некурящий: некурящего некурящий некурящих некурящими 
ознакомительный: ознакомительную 
сайт: сайту сайт сайтам сайтах Сайт сайтов сайта сайте 
античастица: античастиц античастицами античастицы 
почему: Почему почему 
сбываться: сбываются 
описывать: Описывают описывать описывает описывают 
входящий: входящих 
ни: ни Ни 
эффект: эффекта эффекты Эффект эффект 
официальный: официальные официальной официальном 
макбук: макбук 
короткомасштабные: Короткомасштабные короткомасштабные 
космонавтика: космонавтика 
вышеуказанный: вышеуказанной 
коммент: комменты 
нормальный: нормальное нормальный нормальную нормальные нормальных нормальной 
просмотр: просмотров просмотру просмотра 
обойтись: обойтись 
исследователь: исследователям исследователь Исследователь исследователей Исследователи 
пересмотр: пересмотра пересмотром 
косьюмеров: косьюмеров 
дорогостоящий: дорогостоящий 
выполнять: выполняете выполняло выполняет выполняют выполнять 
среднее: среднем 
прилететь: прилететь прилетело 
цод: ЦОД 
формат: форматах форматов форматы формат формата формате 
обратить: обратите обратить 
новинка: новинкой новинки 
спустя: спустя 
символьный: символьной символьный символьные символьное 
обогнать: обогнал 
вносить: вносят 
земля: Земли 
дизель: дизель 
позитронный: позитронно 
климат: климатом 
акцентировать: акцентирует 
получать: Получаем получали получаем получаете получает получать получают 
устранять: устранять 
разложение: разложения 
интеллектуальный: интеллектуальное интеллектуальная интеллектуальным 
написание: Написание написании написания написание 
краткий: кратчайшие краткого 
учебный: учебном учебный 
ослабить: ослабленную ослабленная 
внимание: внимания внимание Внимание 
отлавливать: отлавливает 
поучаствовать: поучаствовать 
добраться: добраться 
безопасный: безопасный безопаснее безопасное безопасным 
цифровизацию: цифровизацию 
принятие: принятию принятие принятия 
пристраиваться: пристраивается 
жалюзи: жалюзи 
чемодан: чемодане 
почти: Почти почти 
вклад: вклад 
обслуживание: обслуживание 
сила: силой силы сила сил 
мышечный: мышечные мышечных 
киберпреступник: Киберпреступникам киберпреступников 
подавлять: подавляющее подавляющем 
встраивать: встраиваемой встраиваемые 
возможно: возможно 
межзубный: межзубной межзубного 
остаться: остался остались останется осталось остаться 
продолжение: продолжением 
исполнитель: исполнителей исполнителям 
дальний: дальний 
пусковой: пусковой 
люминофор: люминофора 
заниматься: занимающиеся занимаются заниматься занимающихся занимаюсь занимается 
подсоединить: подсоединить 
запекание: запеканием 
квинтян: квинтян 
добро: добро 
взаимно: взаимно 
отводиться: отводится 
барьер: барьер 
рассмотреть: рассмотрели рассмотрим рассмотрел рассмотреть 
устаревший: устаревшего устаревшая устаревшие устаревших 
единый: единого единой 
интервал: интервала интервал 
конкретный: конкретном конкретные конкретного конкретной конкретных 
организация: Организация организациями организации организация организаций 
экскурсия: экскурсий экскурсия 
здорово: здорово 
конфиденциальность: конфиденциальности конфиденциальность Конфиденциальность 
продемонстрировать: продемонстрировало 
заклинание: заклинание заклинания заклинаний заклинаниями 
валидность: валидности валидность 
сценарий: сценарии сценариев сценариям сценарием сценарий 
скриншот: Скриншотов скриншотами 
неживой: неживых 
ради: ради 
вычёркивать: вычеркивать 
фиброз: фиброзу 
подобный: подобных подобные подобное подобной подобными подобным подобного Подобные Подобное 
город: города 
кой: Кое кое 
сколково: Сколково 
камера: камеру 
ухудшение: ухудшения ухудшению Ухудшение ухудшение 
очередь: очередь очереди 
розалия: Розалия 
подойти: подошел подойдет подойдут 
только: Только только 
мы: мы нами Мы нам нас 
разрешить: разрешить разрешенных 
антимюон: антимюон 
довестись: довелось 
софт: софта Софт софт софты софту 
приятный: приятны 
модом: модом 
притягивать: притягивающие притягивает 
чаемый: чаем 
обнаруживать: обнаруживать 
продовые: продовые 
уронить: уронили 
безвозвратный: безвозвратное 
важность: важности 
выдавать: выдавать выдавала 
стресс: Стресс стресс 
упрощение: упрощения Упрощение упрощение 
прикус: прикус 
абразивность: абразивность абразивности 
известно: известно 
внутри: внутри Внутри 
миллилитр: миллилитров 
закон: законами закону 
передавать: передавать Передает 
вынести: вынес 
миссия: миссия 
болтать: болтаем 
вместе: вместе Вместе 
смысл: смысле смысл смыслу смысла 
переименовывать: переименовываем 
пресловутый: пресловутые 
соответствие: соответствие соответствия соответствии 
изображение: изображении изображения Изображения изображений изображение 
транзитивность: транзитивности 
переводчик: Переводчик 
предотвращение: предотвращения 
документированиясегодня: документированияСегодня 
миллисекунда: миллисекунды миллисекунд 
быстрый: быстрый быстрыми быстрое быстрым Быстрый быстрые быстрее 
макрос: макросов макросы макрос макросами Макросы макроса 
что: чего Что Чего чему чо что 
призвать: призванные призваны 
редкий: редки реже редких 
из: из Из 
бросить: Бросил бросить брошенной 
захотеться: захотелось 
посетитель: посетители посетителям 
виртуальный: виртуальная Виртуальная виртуальных Виртуальные 
попутно: попутно 
убеждать: убеждали 
переделать: Переделай 
нагрузка: нагрузке нагрузки нагрузку нагрузкой 
возникать: возникала возникают возникать Возникает возникает 
александр: Александр Александра 
оживить: оживить 
движение: движения 
успешный: успешное Успешная успешному успешным 
блокчейна: блокчейна 
исчезать: исчезает исчезающих 
математически: Математически 
перезапуститься: перезапустится 
обновление: обновление обновлений обновлением обновления 
неоправданно: неоправданно 
закуривать: закуривают 
плюс: плюс плюсы Плюс плюсов Плюсы 
очищать: очищающим 
претендовать: претендует 
полицейский: полицейские 
приватность: приватность 
первопроходец: первопроходцев 
зависеть: зависят зависеть зависит зависел 
своеобразный: своеобразная 
заживление: заживления 
возраст: возраст возраста возрасте возрасту возрастом 
споласкивать: споласкивать 
категория: категорией Категории Категория категории категорию категориям категорий 
систематизировать: систематизированные систематизировать 
систематизироваться: систематизируются 
информативный: информативно информативной 
минута: минуту минут минуты 
альфа: Альфа 
коммиты: коммиты 
далёкий: далеком дальше Дальше 
дашборде: дашборде 
копирование: копирования копирование копированию 
подтверждение: подтверждение 
вариативный: вариативный 
ходить: ходил ходят ходить 
более: Более более 
японоязычным: японоязычным 
индустрия: индустрии 
прямо: прямо 
наглядный: нагляднее наглядные 
отладить: Отлаженные 
постараться: постарался постарались 
интегрирование: интегрирования 
тонкий: тонким тонкая 
сюда: Сюда сюда 
калинин: Калинин 
пневмоторакс: пневмотораксу 
локоть: локтей 
сигарета: сигарету сигарета сигареты сигарет сигаретам сигаретах 
несложный: несложных 
финальный: финальный 
си: Си 
низкий: низкого Низкий 
партнёр: партнерами партнеров Партнер 
альдегид: альдегид 
продвигать: продвигаем продвигающая 
разъём: разъема 
клетка: клетки 
докладчик: докладчиков 
патогенный: патогенный патогенному патогенная патогенную патогенной 
чистка: чистку чисткой чистке чистка чистки 
инициатива: инициативы инициативу инициатив 
ритейле: ритейле 
пришеечной: пришеечной 
электронный: электронное электронный электронных электронной электронного электронная 
корнев: корневых 
тип: Типы тип типу типами типа типом типы типов 
потеря: потерю потери 
следить: следят следить следит 
мороз: Мороз 
ли: ли Ли 
бд: БД 
успех: успеха успехов 
квест: квестов 
промокод: промокод 
ороговение: ороговения Ороговение 
понять: Понял понять 
гбайт: ГБайт Гбайт 
трудозатратно: трудозатратно 
скиллов: скиллов 
дорога: дорогу 
подробно: Подробно подробно 
актуальный: актуальному актуальны актуальном актуален актуальная актуальным актуальный актуальные 
оборудование: Оборудование оборудовании оборудование оборудованию оборудованием оборудования 
крайний: крайней 
существование: существовании существование существования 
посмотреть: посмотрим посмотреть Посмотрим 
зачем: зачем Зачем 
денисов: Денисов 
захардкоженные: захардкоженные 
справедливость: справедливость 
датасет: датасет 
богер: Богер 
планировщик: планировщик 
схожий: схожий 
передовой: передовую 
ненадо: ненадо 
конкурент: конкурентов 
многомиллионный: многомиллионной 
почистить: почистит 
раскидать: раскидан 
аннотация: аннотациям аннотациями аннотаций аннотации 
употребление: употребления 
точный: точных точную точное 
страна: странам страны странах стран стране 
фиаско: Фиаско 
дом: домом дома домов дом домах доме дому 
микрофлора: микрофлору микрофлора микрофлоре 
транспортный: транспортными 
источник: источники Источник источниках источник источника источников источникам источниками Источники 
продолжаться: продолжалось продолжается 
ментиментор: МентиМентор 
полином: полиномы полиномом 
верхушка: верхушку 
непрерывный: непрерывным непрерывный 
чистить: чистить чистил чистят 
карма: Карма 
мобильный: мобильный мобильные мобильных 
замок: замок замками 
оглушение: оглушение 
переопределять: переопределять 
заимствовать: заимствованный заимствованного 
подтвердить: подтвердил подтвердить подтвердим подтвердили 
граф: графа 
подробность: подробности подробностей подробностями 
аскон: АСКОН 
выделение: Выделение выделение 
тестер: тестер 
завершаться: завершается 
видеотелефония: видеотелефонии 
изначальный: изначальную изначальной 
курильщик: курильщика курильщики курильщикам курильщиков 
вперёд: вперед 
показатель: показателях показателей 
софтовые: софтовые 
встреча: встреч встрече встречи 
кластер: кластера 
медицинский: медицинских Медицинские медицинскими медицинской медицинские 
уменьшить: уменьшить 
однозначный: однозначного 
вовсе: вовсе 
ножка: ножки 
куча: кучу кучей 
интерфейс: Интерфейс интерфейсы интерфейсов интерфейсом интерфейса интерфейсами интерфейс 
наблюдаться: наблюдается 
свежеть: свежей 
неделя: недели недель неделю Неделя 
детектив: детектив 
васильев: Васильева 
точно: Точно точно 
повторить: повторить 
спазм: спазмов спазм 
коренной: Коренные 
фото: фото Фото 
пользователь: Пользователь пользователях пользователю пользователи пользователей пользователем пользователь пользователя пользователями пользователям Пользователи 
искренний: искренняя 
заключение: заключение заключении Заключение 
решатель: решатель 
идти: шла идет идем 
плечо: плечи плеч 
инъекция: инъекция инъекций инъекцию инъекции 
хабре: Хабре 
неприязнь: неприязнь 
опенсорсную: опенсорсную 
основный: основное Основное основных Основная основным основная основными 
клавиатурный: клавиатурного Клавиатурный 
транскриптомной: транскриптомной 
недопущение: недопущения 
кратковременный: кратковременный 
вестись: ведутся 
нет: Нет нет 
планомерный: планомерная 
снимка: снимками снимок снимкам 
рукавицына: Рукавицына 
профит: Профит 
содержаться: содержащиеся содержатся содержится 
увлекательный: увлекательной увлекательным 
отбирать: отбирали 
эксперимент: экспериментов эксперименте Эксперименты эксперименты 
детальный: детальном 
желаемый: желаемого желаемой желаемых 
под: под Под 
предустановленный: предустановленным предустановленного 
учеткам: учеткам 
гипервизором: гипервизором 
глазков: Глазков 
пугать: пугайте пугающая 
смочь: смог сможем сможет сможете смогли 
подъехать: подъехал 
радиоуправление: радиоуправления 
интерпретатор: интерпретаторы 
др: др 
выходной: выходных выходные 
надеяться: надеемся надеюсь надеются 
терпеливый: терпеливые 
пригодный: пригоден 
непростой: непростых непростой 
туксов: туксов 
установка: установки установке установок Установка установка 
практика: Практики практике практиками практики практика 
график: графиков 
забыть: забыл забыть 
производить: производят производит 
яркий: яркий 
аспект: аспекты аспектов 
секрет: секрет секретов секретами секреты 
хантят: хантят 
отметить: Отметим отметить отметил отмечены отметьте отмечу 
ролик: ролики 
читальный: Читальный читальный 
разница: Разница разницы разница разницу 
антивещество: антивещество 
стоматология: стоматологии 
атрибут: атрибут атрибуте атрибутов 
брать: берет беру берем 
автоматизированный: автоматизированного автоматизированный 
задуматься: задуматься 
отрасль: отрасли отраслях 
прочный: прочный 
впитывать: впитывает 
устойчивость: устойчивости устойчивость 
тринадцать: тринадцати 
наукоёмкий: наукоемком 
мягкий: мягкую мягких мягкие 
возвращаться: возвращается возвращаются возвращаться возвращалось 
действие: действия действий действие 
страница: странице страницу страница страниц страницы 
механизм: механизмов механизма Механизмы механизму 
технологичный: технологичные 
заголовок: заголовок заголовки 
остальной: остального остальном Остальные остальных остальные остальной 
изменить: изменен изменить изменим изменены изменив 
сегодняшний: сегодняшний 
ряд: ряд ряде Ряд ряду ряда 
наталия: Наталия 
элайнеры: элайнеры 
систематический: систематической систематическое Систематическое 
числовой: числовые числовых 
всякий: всякие всякий всякого 
возникнуть: возникнуть Возникнут 
авторство: авторством 
характер: характер характера характером 
казаться: казалось кажется Кажется Казалось казаться 
голубой: голубым 
адаптироваться: адаптироваться 
полость: полость полостью полости 
оказываться: оказываются оказывается 
оперативный: оперативной 
закончиться: закончится 
дыра: дыра дыры дыру 
утечка: утечкам утечки 
сервер: серверу сервером сервер сервера серверы серверов сервере серверами 
отучить: отучить 
научно: Научно научно 
противный: противном 
описательный: описательных 
рекламщик: рекламщикам 
нищий: нищие 
кино: кино 
искусство: Искусство 
приобретать: приобретают 
старацца: старацца 
офлайн: Офлайн 
телеоко: Телеоко 
декабрь: декабря декабре 
мг: мг 
настоятельно: настоятельно 
звать: зовут 
правопорядок: правопорядка 
представимый: представим Представим 
расслабиться: расслабиться 
плюшка: плюшек плюшках 
поверх: поверх 
роутер: роутер 
информационный: информационная Информационная информационных информационные информационной 
щека: щека 
гингивит: гингивит 
сертифицированный: сертифицированных сертифицированным 
выделять: выделяют выделять 
выезд: выезд 
провоцировать: провоцируют провоцирующих 
неудивительный: Неудивительно 
не: Не не НЕ 
смоляной: смоляная 
блокировать: блокирующую блокирующей блокировать блокирует блокирующего 
типизация: типизации 
справиться: Справится 
распознавание: распознавание распознавания 
предложение: предложения 
слушайте: Слушайте 
приживаться: приживались 
память: памяти памятью память 
добавляться: добавляются 
бобёр: Бобров 
суточный: суточной 
пересушивать: пересушиваем 
сквозной: сквозного 
стоящий: стоящих стоящая 
конструкция: конструкциями 
заметный: заметный заметную 
особо: особо 
дегидратация: дегидратация 
вести: ведет вести 
структура: структуру структурах структура 
воспринимать: воспринимают воспринимать 
появляться: появляется появляющихся появлялся появлялась Появляется появляться появляются 
заметно: заметно 
процессорный: процессорное процессорного 
мина: мин Мины минах мины 
обычно: обычно Обычно 
сходство: сходство 
погружение: погружение погружения 
намёк: намеки 
надёжность: надежность надежности 
задний: задней 
посвятить: посвящено посвятил посвящен посвященным 
хирургический: Хирургические 
авторизация: авторизацию авторизации 
губернатор: Губернатора 
мир: мире миру Мир мир мира миров 
поставщик: поставщику поставщика поставщиком поставщик поставщиков 
публично: публично 
хоспис: хосписах 
загадочность: загадочностью 
возможный: возможного возможен возможных Возможны возможной возможна возможное Возможные 
снятой: снятые 
чёткий: четкой четкое четкие Четкая 
ясный: ясная ясна ясного 
скачивать: скачиваемых скачивать 
воплощение: воплощение 
осознание: осознание 
голубаяалгоритм: голубаяАлгоритм 
опора: опоры 
запретить: запретить Запретить 
пора: порах пор 
пкм: ПКМ 
плохо: Плохо плохо 
отставать: отстает 
граничный: граничное 
обгонять: обгонять 
уйти: ушли ушел 
валидация: валидация валидации 
ответ: ответы ответа ответов Ответы ответ 
по: По по ПО 
пропускаться: пропускаться 
метаплазия: метаплазии метаплазией 
раскатывать: раскатывать 
громадный: Громадное 
скажем: скажем 
тревожить: тревожить 
откровенно: Откровенно 
олег: Олег Олега 
повторяться: повторяющихся повторяется повторяются 
радиолог: радиологи радиологов 
редактирование: Редактирование редактирование 
номер: номерами номер номера 
играть: играет играть играли 
узловой: узловым узлового узловой 
будущее: будущем будущее Будущее 
пояснение: Пояснения 
выигрывать: выигрывает 
кража: краже 
кривойвозможные: кривойВозможные 
папиллома: папилломы 
обучениеискусственный: обучениеИскусственный 
производитель: производителей производители производителя 
объектный: Объектно объектно 
целое: целое целом 
детектор: Детектор детектор 
накапливаться: накапливается накапливаются 
моков: моков 
углевод: углеводов 
валидным: валидным 
слепой: слепую 
спавнятся: спавнятся 
крах: Крах 
монопучковыми: монопучковыми 
сверху: сверху 
итого: Итого 
диагностический: диагностический диагностических 
поддельный: поддельным 
битный: битным битной 
мать: Мать 
прилегать: прилегать прилегает 
бонус: бонусах 
младший: Младший 
умение: умения Умение 
опенсорс: опенсорс 
путь: пути Пути Путь путями путь 
фамилия: фамилии фамилия 
выражаться: выражается 
этап: этапам этап этапах этапы этапа Этапы этапом этапов этапе Этап 
прописывать: прописывает прописывают 
избегать: избегать избегает 
отстрелить: отстрелить 
музыка: музыку 
занимательный: Занимательные 
автомобильный: автомобильный 
нервный: нервными 
визуализация: визуализации Визуализация 
окончание: окончаниями окончание 
дешёвый: Дешевые дешевое 
исправить: Исправить 
крыться: кроется 
житель: жители жителей 
двумерный: двумерной двумерную 
метафизический: метафизических 
перспективный: перспективных 
текст: текста текст тексты тексте 
колонка: колонки 
котлин: Котлине 
секретыпоследний: СекретыПоследний 
допустимый: допустимых 
брандмауэр: брандмауэра 
конвейер: конвейер конвейеры 
предпочтение: предпочтение 
микросхема: микросхема микросхемы 
дорабатывать: дорабатывать 
встречаемость: встречаемость 
потребоваться: потребуется потребоваться 
построение: построения построении 
анализироваться: анализируются анализируется 
воздух: воздуха воздуху 
хромать: хромает 
матрикса: матрикса 
видимость: видимости 
памятьну: памятьНу 
выполняться: выполняются выполняться выполняется 
квартира: квартир квартиры квартиру 
нивелировать: нивелировать 
хозяйка: хозяйке 
число: числе числу числа 
стальной: стальные 
заглянуть: заглянуть 
зачастую: зачастую Зачастую 
починить: Починил 
клиенталюбой: клиентаЛюбой 
мацкевича: Мацкевича 
ты: тебя ты 
опосредованно: опосредованно 
работоспособность: работоспособности 
хранение: Хранение хранения 
вычислить: вычислить вычислив 
сколько: Сколько сколько 
исторически: исторически 
проверить: проверим Проверить Проверим проверить проверит проверенные 
публиковаться: публиковаться 
поверхностный: поверхностное поверхностной поверхностный 
геометрический: ГЕОМЕТРИЧЕСКОЕ геометрического геометрическое 
продлеваться: продлевается продлеваться 
крупноузловую: крупноузловую 
выпасть: выпавшего 
компилировать: компилируемый компилирую компилируемыми компилируемого 
отчасти: отчасти Отчасти 
дорого: дорого 
вид: виде виду Виды вид видов вида 
площадь: площадью 
ввиду: ввиду Ввиду 
недоступный: недоступны недоступных недоступным 
разминированиюпроще: разминированиюПроще 
ассоциация: ассоциацией 
иммунодефицит: иммунодефициту 
букет: букет 
терапевт: терапевта терапевт 
повторно: повторно 
исключение: исключением исключение 
виджет: виджет 
одноклассник: Одноклассники 
ловить: Ловим 
обязательство: обязательства 
открыться: Откроется открывшемся 
спокойно: спокойно 
графикадизайн: графикадизайн 
цепочка: цепочку Цепочка 
вариант: вариантов варианты вариант 
культура: культуру Культура культуры 
касательная: касательной 
гелий: гелием гелия гелии гелий 
пытаться: пытаются пытаться пытается пытаемся пытаетесь 
составить: составить составленных составили составленный 
беспровод: беспровод 
гладкость: гладкости гладкость 
консьюмера: консьюмера 
выдать: выдав выдать выдано выданного 
префикс: префиксом 
легковесный: легковесных 
нормально: нормально 
шестиканальный: шестиканальный 
подсказать: Подскажи подскажет 
ребёнок: ребенка детей 
акционер: Акционеры 
комментатор: Комментатор 
выставка: выставка выставке выставку Выставка 
геномный: геномной геномных 
разработчикамтрадиционный: разработчикамТрадиционный 
разрушение: разрушения Разрушение разрушению 
обучать: Обучающие 
отделить: отделить 
компас: КОМПАС 
к: ко 
развлекательный: развлекательная 
влиять: влияющие влиять влияет 
касаться: касались касается касающейся 
заключать: заключаемых 
многие: Многие многие 
расход: расходы расходов 
кроме: Кроме кроме 
ск: СК 
централизация: централизации 
надкостница: надкостница 
окружение: окружение окружения 
впоследствии: Впоследствии впоследствии 
необъятный: необъятное 
читаться: читается читались 
добавиться: добавятся добавился 
серверный: серверную серверных серверной 
пробел: пробелами 
гораздо: гораздо 
поблизости: поблизости 
поставляться: поставляется 
снаружи: снаружи 
анализ: анализа анализу анализе анализ 
ток: ток току 
стол: столе стол 
предусматривать: предусматривает 
гиктаймс: Гиктаймс гиктаймс 
задействовать: задействующих 
неделятоп: неделяТОП 
переписать: переписать 
матричный: матричного 
однако: Однако однако 
формирование: Формирование формирование формированием формирования формировании 
алиса: Алиса Алису 
знаменитость: знаменитость 
среда: среды среде средам средой среду 
ограниченный: ограниченную ограниченный ограниченные 
пароль: пароли пароль пароля паролей 
определять: определяемые определяющие определять определяют определяет 
студент: студентов 
спецификация: спецификацию Спецификация спецификации спецификация 
преподаватель: преподаватель 
способствовать: способствуют 
наряду: Наряду наряду 
скликивания: скликивания 
измениться: изменилось изменился 
герой: героя Герои 
биометрия: биометрии 
последовательность: последовательностями последовательности последовательность 
ненужный: ненужного ненужные ненужным 
нлмк: НЛМК 
наливать: наливают 
дорожный: дорожная 
просто: просто Просто 
снизить: снизить сниженное снижена 
самоуспокоение: самоуспокоения 
понижать: понижающий 
ситуация: ситуациях ситуацию ситуации ситуация ситуациям ситуаций 
идея: идея идей Идея идеей идеи 
сервлетов: сервлетов 
если: Если если 
некий: некую некие некий 
специфический: специфических специфические 
лицензионный: лицензионный 
прежде: прежде Прежде 
корректность: корректности 
тема: темы тема темам теме тему 
довольство: довольства 
молекула: молекулам молекулы 
абразив: абразив Абразивы 
отдаваться: отдается 
конструктивный: конструктивной 
без: Без без 
аффектящие: аффектящие 
позитрон: позитрона позитронами позитроны позитрон позитронов 
асинхронный: асинхронного 
запускать: запускать запускаем запускает 
подгрузить: подгружены подгружен подгрузить 
очиститель: очистители 
владелец: владельцам владельца владельцев 
правый: правой правую правый 
буквально: буквально 
набивать: набиваем 
автонумерация: автонумерация 
аннотатор: аннотаторов 
стать: станет статей стали стал стала стало стать 
существенный: существенной 
обл: обл 
оскар: Оскар 
математик: Математик Математика 
заканчивать: заканчивая заканчиваю 
обучение: обучении обучением обучению обучение обучения 
распознавать: распознают 
куба: Кубы 
алина: Алина 
инновационный: инновационного 
испускаться: испускается 
свободный: свободного свободной 
сообразить: сообразил 
пометить: помечен 
критерий: критерии критериев критериям 
нпо: НПО 
перформанс: перфомансу 
журналист: журналистам Журналист 
крутой: крутой крутым 
всегда: Всегда всегда 
романтизировать: романтизировать 
отборв: отборВ 
волновать: волнует 
заимствование: заимствованиями заимствований 
воля: воли 
элайнерах: элайнерах 
клиент: клиентом клиентов клиентами клиентам клиента 
сторона: сторонам сторону стороны сторон 
снижать: снижать снижает 
создаваться: создается создавался создаются создаваться 
посудить: посудите 
здоровый: здоровом здоровым здоровых 
сок: сок 
ремонт: ремонт 
препроцессор: препроцессора 
достижение: достижению достижения 
сэдя: СЭДЯ 
банковский: банковскую банковские 
замедлить: замедлить 
каталог: каталоге каталог каталогах 
настраивать: Настраиваем настраивать 
щётка: щетки 
доверенность: доверенности 
отскакивать: отскакивают 
востребовать: востребованным 
аудит: аудитов 
пять: пять пяти 
цифровизации: цифровизации 
подача: подачи 
мешать: мешало мешает 
или: или Или 
суперпользователядобавим: суперпользователяДобавим 
привыкнуть: привыкли привыкших 
штука: Штука 
настолько: настолько 
сосуд: сосудов сосуды 
рассуждение: рассуждений 
чтобы: Чтобы чтобы 
приходить: приходите приходит приходить 
настоящий: настоящий настоящее настоящего 
вызывать: вызывает вызываем вызывали вызывая вызывающую вызывают вызывать 
работодатель: работодателя работодатели 
наполнение: наполнение наполнения 
расширить: расширить расширенными расширенный расширенных 
этнический: этнической 
консультант: Консультант 
кт: КТ 
временной: временных 
твой: твою 
консорциум: консорциум 
глубокий: глубже глубокой глубокого 
форматный: форматно форматный 
перезагрузить: перезагрузим перезагружен 
пароксизм: пароксизм 
вдвоём: вдвоем 
вообще: вообще Вообще 
образовать: образуют образующая 
вне: вне 
магистратура: магистратуру 
исправление: исправления исправлению исправление исправлений 
обращать: обращая обращайте обращает 
направлять: направлять направляет 
подгружать: подгружает подгружать 
вынос: вынос выносу 
лист: лист листов Лист листы 
однозначно: однозначно 
возвратить: возвращен 
радиологический: радиологических 
кофе: кофе 
гладилин: Гладилин 
эластичный: эластичны 
скорость: скорости скорость 
строптивый: строптивые 
жкт: ЖКТ 
вячеслав: Вячеслав 
ванильный: ванильный 
лишь: Лишь лишь 
европа: Европе 
энтузиаст: энтузиастов 
уверить: уверена уверены 
ранее: ранее Ранее 
прекрасно: прекрасно 
элементарный: элементарных элементарным 
напрямую: напрямую 
за: за За 
зона: зону зоны зонах 
программный: программных программного программный программным программное 
коэффициент: коэффициенты коэффициент 
бруноям: Бруноям 
ношение: ношении 
бэкдор: бэкдор 
вес: веса вес весов 
режим: режиме режим режимов режима 
удаляться: удаляются 
умолчание: умолчанию 
оператор: операторы 
удостоверение: удостоверений удостоверениях Удостоверение удостоверении удостоверения 
неправильный: неправильны неправильный 
виталий: Виталий Виталия 
обходиться: обходимся 
расширение: расширении Расширение расширения расширение 
оно: Оно оно 
логика: логики логику 
поддерживаться: поддерживаются поддерживается 
страховка: страховка 
кровотечение: кровотечением 
добавлять: добавляют добавлять Добавлять добавляем добавлял добавляет Добавляем 
позволить: позволил позволит позволило 
научиться: научиться 
солома: соломы 
платный: платные платных 
авторский: авторских 
расширяться: расширяются расширяется 
самодельный: самодельного 
счищать: счищать 
яндекс: Яндексе Яндекса Яндекс 
прецизионный: прецизионной 
минус: минусов 
заметка: заметок заметках заметку заметки 
отбеливать: отбеливающих отбеливать отбеливающие отбеливают 
слизистый: слизистой слизистая 
разумеется: разумеется Разумеется 
частник: частник 
незыблемость: незыблемость 
прочитать: прочитайте прочитавших прочитать 
столь: столь 
рекомендовать: рекомендуемых рекомендуем рекомендовать рекомендованных рекомендуют 
оригинал: оригинала 
тёплый: теплыми теплых Теплый 
вакансия: Вакансии вакансии вакансия вакансий 
реджистри: реджистри 
терминал: терминал терминала терминалами терминале терминалу терминалом 
численный: численными 
влажность: влажности 
пустой: пустую пустой 
поступление: поступление 
предупредить: предупредить 
освободить: освободить освободит 
нечто: нечто 
вспотеть: вспотеет 
поставка: поставки 
нпс: НПС 
сапр: САПР 
межпроцедурного: межпроцедурного 
порог: порога Порог порог 
касперский: Касперского 
выполнение: выполнения выполнение выполнением выполнении 
антиматериальные: антиматериальные 
рецептор: рецепторов рецепторы 
триггер: триггером 
отработать: отработает 
получение: получение получения 
кастомного: кастомного 
предел: предел пределами 
бета: бета Бета 
оболочка: Оболочка оболочки оболочка 
язычный: язычной 
пообщаться: пообщаться 
файл: файлу файле файл файлов Файл файлы файла 
импорт: импорт 
отоплениемдоклад: отоплениемДоклад 
учетках: учетках 
полноценный: полноценным полноценного 
присутствовать: присутствует присутствовать 
допускать: допускает 
резорбция: резорбция 
менторить: менторить 
столько: столько 
продленияиз: продленияИз 
прозрачность: прозрачности прозрачность 
социальный: Социальные социального социальных 
при: При при 
пересылка: пересылку пересылки 
высокопрофессиональный: Высокопрофессиональные 
едва: едва 
затормозить: затормозившего 
парвис: Парвис 
составной: составная 
искусно: искусно 
рекурсивный: Рекурсивно 
трое: трое 
игростройство: игростройство 
эффективность: эффективность эффективности Эффективность 
менти: менти 
компактный: компактный 
спасать: спасаем 
общественный: общественного 
вращаться: вращающиеся 
механика: механику 
фильтр: фильтрами 
волнующий: волнующий 
коллизия: коллизий 
монетизация: Монетизация монетизации 
материя: материях материей материи 
эргономист: Эргономист 
шоколадка: шоколадки 
меню: Меню меню 
пластик: пластик 
постепенно: постепенно 
холодильник: холодильников 
пошаговый: пошаговым 
считаться: считаются 
перетаскивание: перетаскиванием 
бросание: бросания 
инстанса: инстанса 
намечаться: намечается 
отрезок: отрезка 
йцукен: ЙЦУКЕН 
финансы: Финансы 
трудно: трудно 
упрощаться: упрощается 
страшный: страшнее страшными 
рождение: рождения 
блочный: блочное блочного Блочная блочную блочная 
робопса: робопса 
неструктурированный: неструктурированные 
мегабайт: мегабайт 
проблемный: проблемные 
разрушаться: разрушается 
значение: значение значения 
восстанавливаться: восстанавливается 
ошибиться: ошибиться ошиблась 
опухоль: опухоли опухоль опухолей 
наличие: наличия наличие 
документирование: документировании документирования 
паттерн: паттерн паттерном паттернов Паттерны 
словесный: словесную 
просканировать: просканировать 
молодёжь: Молодежь 
провалиться: провалились провалилась 
автопилот: автопилота 
реминерализация: Реминерализация 
пятилетний: пятилетние 
ветвление: ветвлению 
скапливаться: скапливается 
отразиться: отразилось 
хозяин: хозяина 
распрямляться: распрямляется 
выражение: выражений выражение выражения 
навигация: навигация навигации Навигация 
ализар: Ализар 
весьма: Весьма весьма 
вкрутить: вкручен 
полнота: полноту Полнота 
бисхабр: бисХабр 
конструктор: конструктором конструкторы конструктор 
дентинные: дентинные 
узнать: узнали Узнать узнал узнаем узнать 
чрезмерный: чрезмерного 
абсолютно: абсолютно 
кюретами: кюретами 
дневный: дневные 
волноваться: волноваться 
отступник: отступника 
сувенир: сувениру 
отличный: Отличная 
оружие: оружие оружия 
вставать: встает 
домашний: домашним 
вещейинженерные: вещейИнженерные 
смириться: смириться 
демотивировать: демотивировать 
общение: общения Общение общению общение 
профиль: профиля Профиль 
дубликат: дубликатов дубликату 
предположение: предположений 
начинаться: начинается 
псевдографический: псевдографическое 
основной: основной основные Основные 
кодирование: кодирование 
линдена: Линдена 
упрёк: упреком 
непросто: непросто 
первоначально: Первоначально первоначально 
битый: бита 
захабренный: Захабренный 
кейс: кейсы кейсов Кейс 
покупать: покупать 
дементьев: Дементьев 
стираемость: стираемости 
сформировать: сформирован сформированы 
примерно: примерно 
гк: ГК 
игрок: игрок игроков игрока 
описываться: описывается 
остановить: остановить остановим 
стоматит: стоматит 
кадавр: кадавра 
припарка: припарка 
наложение: наложение наложения 
разминируются: разминируются 
есть: Есть ест есть 
попытка: попытка попытке 
тепло: тепла тепло 
час: часа часов час 
ответить: Ответить ответим ответил ответить ответили 
поломать: поломали 
краткость: краткости 
пропустить: пропустить пропустил 
контрольный: контрольной контрольные контрольных 
впч: ВПЧ 
некромант: некроманта 
терапия: терапию 
еврокомиссия: Еврокомиссии 
запуск: запуск запуска запуском запуске запуску 
всяческий: всяческие 
кола: колы колой 
омывать: омывает 
значительно: значительно 
пыль: пыль 
запутаться: запутаться 
познакомиться: познакомиться познакомимся 
манифест: манифесте 
неименованный: неименованная 
способомприведем: способомПриведем 
протечекосвещениешторысценариивыставка: протечекосвещениешторысценариивыставка 
секунда: секунду секунды 
закупить: закуплены 
результативность: результативности 
кнопка: кнопка кнопкой кнопку 
опираться: опиралась 
стоимость: стоимость Стоимость стоимости 
абстрактный: абстрактном 
немного: немного Немного 
освещение: освещение освещением 
совершить: совершить 
сканер: сканеры Сканера сканера сканеров 
вех: Вехов 
билет: Билета билет 
пэт: ПЭТ 
комбинировать: комбинировать комбинируя 
сотня: сотнями 
килограмм: килограммов 
эльф: эльфов 
потемнение: потемнение Потемнение потемнения 
печение: печеньем 
пол: полами полу полов 
миллиард: миллиарда 
очистка: очистке очистка очистку 
датироваться: датируется 
истончаться: истончаться 
уходить: уходила уходит 
воздействие: воздействием воздействия 
манипуляция: манипуляций 
загадка: загадкой загадку загадки 
всевозможный: всевозможным 
непосредственно: непосредственно 
перелив: перелива 
коллективный: коллективной Коллективная 
белый: белым Белая белых белый белыми белая 
удобный: удобное удобнее удобный удобного 
компиляция: компиляция компиляцией компиляцию компиляции 
операционный: операционной операционные 
следствие: следствие 
заключениеописанный: ЗаключениеОписанный 
фактический: фактического Фактическая 
суперсимметричные: суперсимметричные 
недопонимание: недопониманий 
заинтересованность: заинтересованность 
ит: ИТ 
совершенствование: совершенствование 
капсула: капсулы 
окулов: Окулов 
френе: Френе 
масса: массу масса 
сложиться: сложилось 
отложить: отложить 
сегмент: сегментом сегмент 
потребность: потребность потребности потребностью потребностей 
выключение: выключение 
оверкилл: оверкилл 
перестать: перестала перестать 
дентин: дентин дентина 
классно: классно 
закупка: закупками закупки 
чат: чаты чат 
бод: бод 
окружность: окружности окружность 
антон: Антон 
онкология: онкологии онкология 
сознательно: сознательно 
наступить: наступил 
прод: прод 
усиление: усиление 
потребитель: потребителей 
пожалуйста: пожалуйста 
лишний: лишнюю Лишнюю лишним лишнего 
вакуум: вакууме 
камень: Камень камнем камень 
зацепляться: зацепляешься 
источниксборщик: ИсточникСборщик 
март: марте марта 
загадочный: загадочный 
неэффективно: неэффективно 
парадоксальный: парадоксально 
конкретно: конкретно 
существующий: существующими существующим существующих существующий существующее 
постоянно: постоянно 
секретовтретий: секретовТретий 
оговориться: оговориться оговорюсь 
монтаж: монтажа 
предприятие: предприятия предприятиях предприятий 
обстановкаиндустрия: обстановкаИндустрия 
таков: Такова 
затянуться: затянется затянуться 
основатель: основателя основатель 
непривычный: непривычная непривычной 
протез: протезы протезу 
предположить: предположил 
опасность: Опасность опасности 
кастомные: кастомные 
безопасность: безопасности безопасность Безопасность 
редко: редко 
внесение: Внесение 
морально: морально 
продуктивность: продуктивности 
плотный: плотная 
сущность: сущности сущность 
браться: браться берутся 
омывание: омывание 
охватывать: охватывающий охватывающая охватывает охватывающие 
цикл: циклом циклу циклами цикл циклов цикла 
топить: топит 
выставочный: выставочного 
картинка: картинке картинка 
стаж: стаж стажа 
призывать: призывать 
немало: немало 
микро: микро 
сергей: Сергей Сергея 
аптека: аптеках 
кармак: Кармак 
предвзятый: предвзятое 
переопределение: переопределения 
целостность: целостности целостность 
неоднозначно: неоднозначно 
проэксплуатировать: проэксплуатировать 
блок: блокам блоком блок 
пропасть: пропала 
поговорить: поговорить поговорим Поговорим 
исторический: историческим 
тысяча: тысячам тысяч тысячу 
стоять: стояла стоят стоять 
персона: персоной 
необязательно: необязательно 
непогрешимость: непогрешимость 
печатный: печатные 
ярл: ярлов 
хранилищарекомендуемое: хранилищаРекомендуемое 
переконфигурировать: переконфигурировать 
универ: универе универ 
составляться: составляется 
продолжить: продолжил продолжим 
повышенный: повышенной 
ничего: Ничего ничего 
микрозазоры: микрозазоры 
дистанционный: дистанционный 
любить: люблю 
сотрудничество: сотрудничеству 
сразу: сразу 
выявить: выявленных выявлено 
советник: Советник 
институт: института институтом 
строиться: Строится 
удивляться: удивляются 
океанский: океанском 
чемоданпо: чемоданПо 
столбец: столбца 
кость: кость кости 
дирак: Дираком Дирак 
сэдв: СЭДВ 
стартап: стартапов стартап стартапа 
пересборки: пересборки 
дерево: дерево 
враг: врагу врага врагов врагам 
протеомной: протеомной 
железно: Железно 
передумать: передумал 
выпадать: выпадающего выпадающем 
отвечать: отвечает отвечал отвечают 
распрямление: Распрямление 
тест: тестов тест теста тесты 
отразить: отражено 
ориентироваться: Ориентируясь ориентироваться 
вирус: вируса вирусы 
явно: явно 
стекстек: СтекСтек 
нерелевантный: нерелевантный 
присваивать: присваивать 
переадресация: переадресация переадресации 
двухканальный: двухканальный 
столполучить: столПолучить 
пропускать: пропускают 
локально: локально 
межпризменного: межпризменного 
предпочтительный: предпочтительнее 
клавиша: клавиш 
лидер: лидер лидером 
рутина: рутину 
захардкодить: захардкодить 
стадия: стадии стадий стадиях 
го: го 
базис: базисы 
согласованность: согласованность Согласованность 
утверждать: утверждают 
непонятно: непонятно 
горячее: горячего 
погодозависимой: погодозависимой 
потерянный: потерянному 
общаться: общаемся общалась общаются общаться 
кибербез: кибербез 
фантастический: фантастических 
телефонный: телефонного телефонные Телефонный 
неужели: неужели 
убыль: убыль 
увы: увы 
мб: Мб МБ 
налогообложение: налогообложения 
нововведение: нововведения нововведений 
ущерб: ущерб 
интента: интента 
вещество: вещества вещество веществе 
сохранение: сохранении сохранению сохранения 
объяснение: объяснения 
станция: станции 
подбирать: Подбирайте подбирает 
неравнодушный: неравнодушен 
прожить: прожить 
проявиться: проявились 
локализовать: локализовать 
экземпляр: экземпляр 
провести: провел провести провела 
сужать: сужает 
сохраняться: сохраняться 
частота: частота частоты частоте 
внешний: внешние внешней внешнего внешний 
переделывать: переделывать 
хронический: хронического 
будущий: будущих 
гато: Гато 
норма: норм норме норма 
пропионовый: пропионовый 
скоро: скоро 
бесплатно: бесплатно 
анализировать: анализировать 
водительский: водительских водительского 
обычный: обычном обычным обычной обычных 
рана: рана 
пролить: пролить 
отправной: отправной 
положить: положить 
выглядеть: выглядеть выглядит 
далее: далее Далее 
провалить: проваленных 
кофеиновый: Кофеиновая 
объявление: объявлений объявление объявления 
пациентка: пациентка 
пожарный: Пожарно 
утекать: утекает 
гибридный: гибридные гибридных гибридный 
ну: Ну ну 
файлазнание: файлазнание 
середина: середине 
распаковка: распаковку 
логичный: Логичным 
том: тома 
двемерские: двемерские 
монстр: монстр 
безопасника: безопасника 
грубо: Грубо 
данил: Данил 
общедоступный: общедоступным общедоступный общедоступные 
законодательство: законодательство законодательстве 
немецкий: немецкие 
очистить: очистил очистить очищенных 
иллюстрация: иллюстрациями иллюстраций 
прежний: прежним прежнему 
гаджет: Гаджеты 
фрилансер: фрилансер 
безопасностидля: безопасностиДля 
эксплуатировать: эксплуатировать 
взять: возьмут взял взять взятые 
послезавтра: послезавтра 
инфоцентр: Инфоцентры 
школа: Школа школе 
официально: официально 
хотц: Хотц 
дополнить: дополнит 
зазор: зазоры зазор 
либо: либо Либо 
контентный: контентными 
удобство: Удобство 
мощный: мощных помощнее мощнее 
молдаван: Молдаванов 
вычитать: вычитать 
подключаться: Подключайтесь 
розетка: розетками 
небыстрый: небыстрой 
доза: доз 
рутинный: рутинных 
норматив: нормативов 
бумага: бумага 
наведение: наведении наведению 
моральный: моральное 
привилегия: привилегии 
упростить: упростил упростить 
всесторонний: всестороннее 
урон: урону 
опустить: опустил 
достигать: достигать 
равномерный: равномерное 
помнить: Помним 
хабр: Хабр 
хардкор: хардкор 
форки: форки 
альянс: Альянс 
классифицироваться: классифицируются 
личность: личности личность 
сухой: сухие 
фокусироваться: фокусироваться 
подрозетник: подрозетник 
макросовинструмент: макросовИнструмент 
невылеченный: невылеченном 
кратко: Кратко 
мост: мост моста 
консоль: консоли консоль 
налёт: налет 
версионированию: версионированию 
отдел: отделах отделов отдела 
расставаться: расставаться 
рпг: РПГ 
микротрещина: микротрещины 
наименее: наименее 
ежегодный: Ежегодный 
уставка: уставка 
бронь: брони 
справа: справа 
ротоглотка: ротоглотки 
он: Он ему его него Его он нему 
идеально: идеально Идеально 
криогенный: криогенным 
пища: пищи 
дверь: дверь 
обновлениеобновление: ОбновлениеОбновление 
популярноеразработка: популярноеРазработка 
усечь: усеченная 
удаться: удалось 
отладка: отладке 
верить: верят верю 
нанимать: нанимать 
минь: Мини 
микротрещены: микротрещены 
эмоциональный: эмоциональных Эмоциональный 
отключение: Отключение 
персонализировать: персонализированное 
усиленный: усиленной 
характеристика: характеристики 
иммунизация: иммунизации 
неизвестный: неизвестную неизвестные 
переделка: переделке 
половой: половым 
методология: методологии Методология 
аккуратно: аккуратно 
претендент: претендентами 
сотрудник: Сотрудники сотрудник сотрудников сотрудника 
кибербезопасность: кибербезопасность 
мега: Мега 
подать: подали 
ощутимый: ощутимых ощутимый 
фидбэк: фидбэк 
леветь: левел 
окрасить: окрашенный 
анатомия: Анатомия 
огрубеть: огрубевший 
определиться: определимся определились 
лишённый: лишенный 
нейтральный: нейтральная 
отравление: отравление 
свиток: свиток 
синтез: синтеза 
сжатие: сжатие 
заодно: заодно 
помещать: помещать помещая 
активно: активно 
принтер: принтера принтер 
оптический: Оптическое 
стык: стыка 
начинающий: начинающих 
метрика: метрик метрику метрики 
где: где Где 
эксплуатация: эксплуатация эксплуатации 
встретить: встретить 
голубика: голубику 
ротовой: ротовой ротовую 
департамент: Департамент 
вырастить: вырастить 
делопроизводство: делопроизводства 
знание: знаниями знания знаний 
попов: Попов 
безболезненно: безболезненно 
универсальность: Универсальность 
предусмотреть: Предусмотрено предусмотрена 
ресивер: ресивер 
предоставить: предоставлен предоставленной 
ровно: ровно 
преграждать: преграждающая 
синхронизация: Синхронизация 
собранный: собранной собранные 
специально: специально 
капитонов: Капитонова 
эвристика: эвристика эвристике 
совместно: совместно 
подходящий: подходящим подходящие 
термин: термин 
попробовать: Попробуем попробовать попробовали попробую попробовал 
страхование: страхования 
менеджмент: менеджмента Менеджмент 
продакшне: продакшне 
ростелеком: Ростелеком 
преобразовать: преобразованной преобразовать 
насколько: насколько 
теоретически: Теоретически теоретически 
отклик: откликов отклик отклика 
карьера: Карьере карьеру карьера Карьера 
наоборот: наоборот 
значок: значки Значки 
принципиально: Принципиально 
ноутбук: ноутбуки ноутбука ноутбуке 
сомневаться: сомневалась 
копать: копает копают копать 
учебник: учебников 
всемирный: Всемирной 
замедлитель: замедлителе 
скуд: СКУД 
доминтернет: домИнтернет 
обучить: обучить 
преобразование: преобразования преобразований 
море: моря 
развеивать: Развеиваем 
лично: лично 
структурирование: структурировании 
неплохо: неплохо 
подобие: подобие 
световой: световые 
поддержание: поддержанием поддержание 
выявлять: выявлять 
исследовать: исследует исследовать исследуют исследуем 
истина: истины истинами 
замкнутость: замкнутости 
лабораторный: лабораторных лабораторной 
любопытно: любопытно Любопытно 
вода: воды 
покурить: покурить 
смена: смене 
аппроксимационную: аппроксимационную 
условно: условно 
выгорание: выгорания 
рекомендация: рекомендациях рекомендации Рекомендации рекомендаций 
прекратить: прекратила прекратить 
глубоко: глубоко 
одинаково: одинаково 
комбинация: комбинации комбинация 
потом: потом Потом 
мотивировать: мотивировать мотивирует мотивировало 
разрушать: разрушать разрушает 
бессрочно: бессрочно 
заходить: заходя 
захардкоживанию: захардкоживанию 
раса: расы рас 
неточный: неточен неточные 
принципиальный: принципиальное принципиальной 
сертификация: сертификаций 
враждебный: враждебных 
контактный: Контактная контактный 
конкурентоспособный: конкурентоспособными 
геном: генома 
продукция: продукцией 
котенков: Котенков 
физик: физик 
сплайновых: сплайновых 
делить: делят делит 
дёргать: дергает 
шлюз: шлюзов 
летучий: летучих 
короткий: короткой короткий короткие 
финал: финал 
запас: запас 
зарождаться: зарождающемуся 
обсуждаться: обсуждается 
безопасностьалгоритмымашинное: безопасностьАлгоритмыМашинное 
незаметно: незаметно 
глюон: глюонами глюонов 
спектроскопия: спектроскопии 
никуда: никуда 
недоучка: недоучка 
источниккроме: ИсточникКроме 
закорачивает: закорачивает 
циклический: циклического 
производительный: производительных 
родительский: родительского 
подписка: Подписки 
вынудить: вынуждены 
патрулирование: патрулирования 
скрывать: скрывает 
дамп: дампа дампе дампов дампы 
метаданные: метаданных метаданными метаданные 
италия: Италии 
спросить: спросить спросит 
отдать: отдали отдала 
сожаление: сожалению 
сеньор: сеньоров 
достигнуть: достигнута 
недавний: недавнем 
привлекать: привлекают 
дополняться: дополняется 
университет: университетах университета 
сообщать: сообщать 
конвертировать: конвертировать 
полиномиальный: полиномиальной полиномиальная полиномиальный 
строй: Строй Строю 
задонатить: Задонатить 
хотеться: хочется хотелось 
дзен: Дзен 
сундук: сундук сундуки сундуков сундуке 
языковый: языково 
кодогенератор: кодогенератор 
кариес: кариес Кариес кариеса 
подозревать: подозреваю 
уделять: уделять уделяли 
сеттинг: сеттингов 
кратное: кратное 
кан: Кан 
координировать: координирующая 
эмпирически: Эмпирически 
прийтись: придется пришлось 
надёжно: надежно 
влад: Влад 
бы: бы 
слабый: слабого 
ресничка: реснички 
завести: завести 
обнаружение: обнаружения 
долго: долго 
сводиться: сводятся сводиться сводится 
упавший: упавшего 
труднопроницаемый: труднопроницаемый 
удлинённый: удлиненный 
параллельный: параллельным 
навигационный: навигационные 
иностранный: иностранной иностранных 
обещать: обещают 
отвлечься: отвлекся 
тариф: тарифы тарифа Тарифы 
белые: Белые 
редактироваться: редактируются 
коэфффициентом: коэфффициентом 
звоночек: звоночек 
паспорт: паспорт 
участие: участие участия 
оплатить: оплатить 
керамический: керамических 
администратораданетподдержка: администратораданетподдержка 
заключениевыставка: ЗаключениеВыставка 
луч: лучи лучей 
смола: смол смолы смолами 
отсутствие: отсутствии отсутствие 
рынок: рынке рынка рынок 
заявка: заявок заявками 
мусор: мусор мусора 
пул: пула пул пулу 
неправильно: неправильно 
единство: единства 
означать: означает 
накладный: накладных накладные 
свечение: свечении 
максимум: максимум 
отрисовку: отрисовку 
алфавитный: алфавитно 
пересчёт: пересчета 
микроконтроллер: микроконтроллеры микроконтроллеров 
поинтересоваться: поинтересовалось 
учёт: учет учетом 
голова: голове голову 
книжка: книжки 
магазин: магазинам магазинов 
ролевый: ролевых 
потратить: потратить 
песочница: песочницы песочнице Песочница 
дважды: дважды Дважды 
мотивированный: мотивированный мотивированными 
нечего: нечем 
раскладка: раскладки раскладка раскладок 
опросить: опрошенных 
прорекламировать: прорекламировать 
порекомендовать: порекомендовать 
вернуться: Вернуться 
онлайн: онлайн 
генерация: генерации генерацией 
фишка: фишки 
мигуцкий: Мигуцкий 
долгий: дольше подольше Долгая долгие долгих 
стэнфордского: Стэнфордского 
термостат: термостатов термостатами 
распространение: Распространение распространения распространению 
охват: Охват 
ксеростомия: ксеростомия 
обращение: обращения 
образовываться: образовывался 
найтись: найдется найдутся нашелся 
ладный: Ладно 
здесь: Здесь здесь 
микросервисе: микросервисе 
степень: Степень степени 
чисто: чисто 
путешествие: путешествий 
регенерация: регенерации 
рекомендоваться: рекомендуется 
отступамиинструмент: отступамиИнструмент 
нуждаться: нуждающимся нуждаться 
сосредоточиться: сосредоточимся 
нравиться: Нравится нравилось нравится 
бактерия: бактерий бактерии 
ведь: Ведь ведь 
препарат: препаратам препараты 
квантовый: квантовую 
фактор: фактор факторов 
согласие: согласия 
разметить: Размечу размеченные 
подземелье: подземельях подземелий 
временами: временами 
командный: командных командная командной 
снимать: снимают Снимая снимать снимая 
входной: входные входных входной 
пресс: Пресс 
недвижимость: недвижимость 
желательно: желательно 
фиксить: фиксить 
с: Со со 
адаптация: адаптации 
выпускаться: выпускается 
успеть: успеет 
обечайка: обечайки обечаек 
экран: экране экран экрана 
приземлить: приземлить 
международный: Международным международные Международная международных Международной 
актор: актора 
вуз: вузах 
отнять: отнять 
подключиться: подключиться подключимся 
джунов: джунов 
локализация: Локализация 
семинар: Семинары 
дед: Дед 
резервный: резервному 
специализировать: специализированными 
зависать: зависать 
сексуальный: сексуального 
излучение: излучения излучение 
сохранить: Сохраненные сохранить сохраним Сохраним сохранено Сохранить 
завершиться: Завершившийся 
прополоскать: прополоскать 
пентестеров: пентестеров 
мигрировать: мигрировать 
яхтинг: яхтинг 
пятый: пятого 
шоколад: шоколаде 
работойс: работойС 
фильтрация: фильтрации 
документооборотиибизнес: ДокументооборотИИбизнес 
итем: итем 
спрашивать: спрашивал 
суперкомпьютер: суперкомпьютеры 
тигран: Тигран 
надпись: надписи 
окошко: окошко 
инициировать: инициировать 
вроде: Вроде вроде 
хрестоматийный: хрестоматийными 
понятный: понятным понятны понятные понятный 
заранее: заранее 
давно: давно 
публиковать: публиковать публикуемые 
долина: долины 
доступно: доступно 
дабы: дабы 
кровоснабжение: кровоснабжение 
призыв: призыва Призыв призыв 
анонимный: анонимные 
провод: провод 
укрупнённый: Укрупненная укрупненные 
правоохранительный: правоохранительных 
насчёт: насчет 
служба: службы Служба 
щёлк: щелк 
котёл: котлом котла Котлов котлов 
рекламироваться: рекламируются 
энергия: энергией энергию Энергия энергий 
ракурсовчтобы: ракурсовЧтобы 
основное: основном 
стимулировать: стимулировало 
пародонтит: пародонтит 
сдвигаться: сдвигаться 
хранить: хранить 
отбелить: отбелить 
доменный: доменным 
кожаный: кожаные 
приводиться: приводятся 
объединять: объединяя объединяют 
расстроить: расстроил 
регуляторный: регуляторными 
невидимый: невидим невидимая 
разрешенийв: разрешенийВ 
когда: когда Когда 
передаваться: передаются передается 
дуга: дуге дугой 
уменьшиться: уменьшился 
необычный: необычных 
расширять: расширять расширяют расширяем 
интеллектздоровье: интеллектЗдоровье 
лента: ленты ленте лентами 
изменять: изменять 
киберугрозах: киберугрозах 
запускаться: запускается запускаться 
реклама: Реклама рекламой рекламы 
юридический: юридической юридическими 
экспорт: экспорт 
греться: греется 
автоматически: автоматически 
вывод: вывода вывод Вывод выводом выводы 
точнее: точнее 
сопоставляться: сопоставляются 
геймдева: геймдева 
совершенно: совершенно 
единица: единицы единиц 
детализация: детализации 
заживать: заживать 
конечно: Конечно конечно 
сайентисты: сайентисты 
диэлектрический: диэлектрической 
недопустимый: недопустимые 
наставник: наставник 
дмк: ДМК 
валидных: валидных 
нога: ноги ногу 
жизнь: жизни жизнь 
документациядля: документацияДля 
напомнить: напомнить напомним 
локация: локаций 
образование: образования образование образованию 
высококачественный: высококачественной 
рейка: рейку 
защитный: защитную защитный защитная 
запустились: запустились 
ракета: ракет 
повысить: повысить повышен 
собственник: собственнику 
обвязка: обвязкой 
популярность: популярностью популярности популярность 
радиология: радиологии 
изобразить: Изобразим изобразим 
гистология: гистологии 
спин: спин 
цифра: цифр цифры 
лига: Лига Лиге 
семейство: семейства 
надо: надо Надо 
маша: Маша 
флагманский: флагманским 
несмотря: Несмотря несмотря 
введение: Введение 
прямой: прямого прямой 
нативный: нативном нативных 
собственно: собственно 
подопечный: подопечному подопечный 
вследствие: Вследствие 
забирать: забирать 
источникзачем: ИсточникЗачем 
михайлов: Михайлов 
родить: родить 
бесконечность: бесконечности 
дания: Дании 
пояснить: поясню пояснить 
синтаксис: синтаксиса 
тимур: Тимур 
прививать: Прививаем 
витамин: витамина 
здравоохранение: здравоохранения здравоохранении здравоохранение 
рассматривать: рассматривать 
всерьёз: всерьез 
коллаген: коллагена 
также: также Также 
местоположение: местоположения 
линукс: Линукса 
гепатит: гепатиту 
недоставать: недостающий 
глина: глины 
заблокировать: заблокирует 
экономический: экономическую экономической 
электроника: электроники Электроника 
уделить: Уделить уделить 
мегапроект: Мегапроекты 
диагноз: диагнозы 
иконка: иконками 
продакшена: продакшена 
комната: комнаты 
полигональный: полигональных 
неверный: неверна 
перекрёстный: перекрестно 
посещение: посещения 
стиль: стиль стиля Стиль 
реплантация: Реплантация 
дева: дев 
переезжать: переезжает 
согласование: Согласование согласования согласований 
плотно: плотно 
борт: борту 
визуальный: визуальная визуальный 
вычисление: вычисления вычислении 
формальный: формальных 
подсказывать: подсказывало 
игрнаучно: игрНаучно 
отчёт: отчетов 
усугубление: усугубление 
гайда: гайд 
техлид: техлид 
онкологический: онкологической 
прогресс: прогрессе 
никто: никто никого 
чувствительность: чувствительности 
русифицировать: русифицированную русифицированном 
взаимодействовать: взаимодействовать 
собака: собаку 
микросервисной: микросервисной 
скрейпе: скрейпе 
обладать: обладать обладает 
перекраивание: перекраивание 
пробный: пробную 
наполнить: наполненные 
пародонт: пародонт 
существо: существ существа 
ревью: ревью Ревью 
приниматься: принимается 
бывший: бывшей бывшая бывшего 
тратить: тратить тратит 
уменьшение: уменьшение уменьшения 
хабах: хабах 
элайнеров: элайнеров 
тайна: тайна 
сарафанный: сарафанное 
ошибаться: ошибаюсь 
определить: определить определено 
удаваться: удавалось удается 
способный: способны способное способную 
следовать: следует следовать Следует 
всплыть: всплыло 
расхождение: расхождение 
стрелочка: стрелочками 
ценность: ценность ценности 
фотография: фотографии фотографиями 
градиент: градиент 
типизировать: Типизированная Типизированный 
девушка: девушки 
андерсон: Андерсон 
игнорировать: игнорирует игнорирующие 
директе: Директе 
переехать: переехало 
аннотирование: аннотирования 
инс: ИНС 
непарный: непарных 
регулярно: регулярно 
стейкхолдеров: стейкхолдеров 
полностью: полностью 
достаться: досталась досталось 
смартфон: Смартфоны смартфонах смартфоны 
василий: Василий 
устанавливаться: устанавливаются устанавливается 
автопилотирование: автопилотирования 
листать: Листая листать 
ускорение: ускорение 
спасибо: Спасибо спасибо 
шейка: шейки 
ухаживать: ухаживать 
уравновешенность: Уравновешенность 
идеальный: идеальное 
ирригатор: ирригаторы 
немудрено: немудрено 
нарушать: нарушает 
увеличить: увеличить 
верстальщик: верстальщикам 
откуп: откуп 
привлекаться: привлекаться привлекается 
яркость: Яркость 
идеал: идеале 
космология: космологии 
умолчаниюв: умолчаниюВ 
занять: занять заняла займет 
кусочно: кусочно 
принуждать: Принуждать 
выше: выше 
фиксировать: Фиксирует 
снимок: снимке снимков снимки снимках 
производный: производные 
наконец: Наконец наконец 
ов: ов 
проследить: проследить 
пополам: пополам 
экстремальный: экстремальной 
золотой: золотое 
галочка: галочки галочку 
врачебный: врачебные 
черника: чернику 
электрический: электрическими 
многофакторный: многофакторной 
выясниться: выяснилось 
кибербезопасности: кибербезопасности 
ретенция: ретенции 
аккаунт: аккаунт 
метастабильный: метастабильный 
очевидный: очевидные очевидным очевидно Очевидно 
отлаживать: отлаживать 
таинственный: таинственный 
модовскими: модовскими 
тег: Теги 
спавна: спавна 
самостоятельно: самостоятельно 
карл: Карл 
редактировать: редактировать 
классный: классную 
медленный: медленным медленнее 
дроплетов: дроплетов 
продуктовый: продуктовой Продуктовый продуктовую 
майнер: майнер 
функциональный: функциональную функциональное функциональных 
проницаемость: проницаемости 
настольный: Настольные настольные настольных 
госпитализация: госпитализаций госпитализации 
инспекция: инспекции 
левый: левой 
управленческий: управленческих управленческие 
вероятность: вероятность 
вечный: вечное 
мейнстримным: мейнстримным 
межпризменное: межпризменное 
зал: зал 
на: на На 
амиров: Амирова 
уникальность: уникальность 
видеодисплей: видеодисплеем 
заряд: зарядом заряд 
поковыряться: поковыряться 
коннектор: коннекторы 
дорогой: дорогие дороже 
прекращать: Прекращаем прекращает прекращают 
гость: Гости 
гб: ГБ 
право: права правом прав право 
хирургия: хирургии 
квиз: квиз 
бороться: бороться 
загрузиться: загрузится 
форматирование: форматирование форматирования 
нейровизуализаций: нейровизуализаций 
подгрузка: Подгрузка 
проектв: проектВ 
паталогический: паталогический 
тимлид: тимлид 
костыль: костыли костыль 
микрочастица: микрочастицы микрочастицами 
уничтожать: уничтожает 
нетология: Нетология 
огрубевать: огрубевает 
корпус: корпуса корпусах 
извращение: извращения извращениями 
костенков: Костенков 
псевдографика: псевдографика 
перезагрузка: перезагрузки 
зрение: зрения 
закомитили: закомитили 
откладывание: откладыванию 
поесть: поесть 
китай: Китае 
величина: величине 
повторный: повторной 
январь: января январе 
слушать: слушали 
ре: ре 
добиться: добиться 
чинить: чинить 
применять: применяемыми применяют применять 
иск: иск иске 
владимир: Владимир 
резекция: резекции 
предварительно: предварительно 
конверсия: конверсии 
хабы: Хабы 
гит: гит 
джон: Джон 
холодный: холодной 
магия: магия 
туториала: туториала 
инфосистемы: Инфосистемы 
выкинуть: выкинут 
настучать: настучать 
богера: Богера 
подчеркнуть: подчеркнутые 
подсистема: подсистемах 
прилагать: прилагать 
анастасия: Анастасия 
нерв: нервы 
подтверждаться: подтверждается 
порождать: порождает 
кастомных: кастомных 
отдельно: Отдельно отдельно 
адаптировать: Адаптируем 
перенаправить: перенаправить 
ассемблер: ассемблера 
прогнозировать: прогнозирующую 
хоть: хоть 
группировка: группировки 
сепсис: сепсисе 
полагать: Полагаем 
внедрить: внедрили 
сезон: сезон сезона 
астрономиянаучно: АстрономияНаучно 
бочка: бочку 
завершение: завершения 
называться: называется называются 
осесть: осевший 
деминерализация: деминерализации 
баг: баг баги 
бесконечный: бесконечна 
затронуть: затронул затронута 
отбор: отбор отбора отборы 
послать: пошли 
облачить: Облачить 
турция: Турции 
дно: дно 
впрочем: впрочем 
рассмотрение: рассмотрению рассмотрении 
гистопатологических: гистопатологических 
шкатулка: шкатулку 
персональный: персональной 
зарубежный: зарубежных 
кираса: кирасы 
закрываться: закрывается 
повлиять: повлияло повлиять 
бинормаль: бинормали 
эмиграция: эмиграция 
прочий: прочие прочими прочих 
полноправный: полноправные 
избыток: избыток 
галактика: галактики галактике Галактики 
однопоточный: однопоточный 
резолверов: резолверов 
превратиться: превратился 
там: там Там 
тогда: тогда 
ниже: Ниже ниже 
типичный: типичные 
климатический: климатической 
отправляться: отправляется отправляются 
читаемый: читаемое 
микрощели: микрощели 
соцсеть: соцсетях 
уверенно: уверенно 
унаследовать: унаследованную 
толпа: толпы 
мысль: мысль мысли 
линейка: линейке линейкой линейка 
слышать: слышали слышал 
гистерезис: гистерезис 
теплоноситель: теплоносителя 
пересчитать: пересчитать 
обязательно: обязательно 
сказываться: сказывается 
ия: ИИ 
даже: даже Даже 
недостаточно: недостаточно 
гайка: гаек 
скобка: скобок скобками 
япне: ЯПне 
продьюсеров: продьюсеров 
падать: падает 
академический: академической 
дипфейком: дипфейком 
принести: принесут 
субатомный: субатомными 
естественный: естественной 
лечение: лечения лечение лечении 
чек: чек 
кабельный: кабельные 
исчезнуть: исчез 
связывать: связывает 
техно: техно 
реле: реле 
животное: животным 
ирина: Ирина 
эпидемия: эпидемий 
идентифицировать: идентифицировать 
круговой: круговой 
вирусный: вирусному 
течение: течением течение 
подтверждать: подтверждает подтверждаем 
отношение: отношении отношение 
проводиться: Проводится проводится 
молочный: молочные 
оговорить: оговоренных 
смарт: смарт 
умеренно: умеренно 
ответственность: ответственности 
голос: голосов 
тоже: Тоже тоже 
тим: Тима 
породить: порождено 
кипеть: кипящей 
копнуть: копнуть 
маршрут: маршруты 
воспроизводить: воспроизводить 
вагнер: Вагнер 
умирать: умирать 
идентичный: идентичными 
проповедовать: Проповедую 
субъективный: субъективным 
взамен: взамен 
внушительный: внушительные 
проиграть: проиграли 
напортачить: напортачить 
периодонт: периодонт 
нейросетевого: нейросетевого 
окрестность: окрестности 
побочный: побочные 
тон: тон 
динамический: динамический 
платёж: платежей 
указывать: указывать указывает указывали 
шпаргалка: шпаргалке 
фрагментированность: фрагментированность 
доверие: доверия 
профильный: профильных 
закардкоженные: закардкоженные 
невольно: невольно 
столкновение: столкновении 
микроскопический: микроскопических 
шоссе: шоссе 
физически: физически 
прийти: Пришло пришел пришла прийти придет Прийти 
предназначение: предназначение 
тренд: трендов тренды тренд Тренды 
лечить: лечить 
резать: резать 
ефименко: Ефименко 
типографика: типографика 
доложить: доложить 
аналогия: аналогии 
препятствовать: препятствуют 
проволока: проволоки 
пиксельных: пиксельных 
болеть: болит болейте 
анализатор: анализаторам анализатор 
самоокупаемость: самоокупаемость 
выполнимый: Выполним 
заглавный: заглавные 
цинга: цинга 
вычисляться: вычисляется 
маг: мага 
бросаться: бросающийся 
тесно: тесно 
ножницы: ножницы 
наладить: наладить 
хост: хост хостом хосте 
просмотреть: просмотрев просмотреть 
октябрь: октября 
гик: гиков 
возрастать: возрастает 
настраиваться: настраивается 
чистый: чистой 
правка: правок правки 
привлечение: привлечением привлечение привлечения 
стройка: стройка 
дашборды: дашборды 
бич: бич 
буферы: буферы 
повышать: повышает 
мидл: мидл 
простаивать: простаивало 
пережить: пережил 
интегрировать: интегрирует интегрировать 
базироваться: базироваться 
генерироваться: генерируются 
диагностирование: диагностировании 
первичный: первичная первичной 
прогнозирование: прогнозированию 
регламент: регламент 
низкоабразивные: низкоабразивные 
госпиталь: госпиталя 
статусный: статусные 
хотя: хотя Хотя 
значимость: значимость 
выступить: выступили выступил 
опасный: опаснее 
аниме: аниме 
лебедев: Лебедев 
тщательно: тщательно 
реанимация: реанимации 
ярлык: ярлык 
четвёртый: четвертого четвертым 
коробейник: Коробейников 
онтико: Онтико 
скомпрометировать: скомпрометирован 
вручить: Вручить 
вольфганг: Вольфганг 
неожиданно: неожиданно 
репараметризуем: репараметризуем 
достоверность: достоверность достоверности 
приступить: приступить 
пузырь: пузыре 
рф: рф РФ 
скоординировать: скоординированных 
февраль: февраля февраль 
обсерватория: обсерватория 
краеугольный: Краеугольным 
щит: щита щит щиты 
приглашение: приглашение приглашения приглашению 
железопоследовательный: железопоследовательный 
снятие: снятия снятие 
хекслет: Хекслет 
повторять: повторять 
поправка: поправкой 
покивать: покивали 
звучать: Звучит 
проектировать: проектировали проектировать 
отзывчивость: отзывчивости 
программированиемакросмакросыпрепроцессорс: программированиемакросмакросыпрепроцессорс 
волков: волков 
раствор: растворы 
вручную: вручную 
маркет: Маркета 
клиницист: клиницистах 
прочее: прочее 
макропроцессор: макропроцессора макропроцессор 
нейтрино: нейтрино 
переживать: переживает переживают 
поэтому: поэтому Поэтому 
выстраиваться: выстраивается 
расчётливый: расчетливым 
автономный: автономном 
ки: ки 
занести: занесли 
минимализм: Минимализм 
фонд: фондов 
человечество: Человечество 
расходование: расходованием 
стоматолог: стоматологов Стоматолог стоматолога стоматологу 
голованов: Голованов 
мурзина: Мурзина 
совпадение: совпадения 
напротив: напротив 
прослеживаться: прослеживается 
крохотный: крохотного 
вычислять: вычислять 
брайт: Брайт 
выдержка: Выдержка выдержка 
степанкин: Степанкин 
прочность: прочность 
наружный: наружной 
хорошо: хорошо 
столбцы: столбцы 
лентяй: лентяев 
резолвера: резолвера 
съесть: съел 
неточность: неточности 
раздутый: раздутом 
сбермаркет: СберМаркет 
эскалация: эскалация 
субд: СУБД 
полнофункциональное: полнофункциональное 
моделирование: моделирование моделирования МОДЕЛИРОВАНИЕ 
панель: панели 
серьёзный: серьезные серьезное серьезных 
чётный: четному 
удвоиться: удвоилось 
честный: честный 
аутсорс: аутсорс 
черно: черно 
пребывание: пребывания 
пожилой: пожилых 
свыше: свыше 
скорее: скорее Скорее 
искусственный: Искусственный искусственного 
безотносительно: безотносительно 
готовить: Готовьте 
элайнерами: элайнерами 
стеноз: стеноз 
проде: проде 
млн: млн 
хабраархив: хабраархив 
релизными: релизными 
снизу: снизу 
видимо: Видимо видимо 
снаряжение: снаряжение снаряжения 
затруднить: затруднить 
развёртывание: развертывание 
аннигилироваться: аннигилируются 
улыбаться: улыбаюсь 
зафиксировать: зафиксированы зафиксированных 
компилироваться: компилируется 
нельзя: нельзя 
посчитать: посчитаны 
катерина: Катерина 
запад: Западе 
напоминать: напоминаю 
жёстко: жестко 
извлечение: извлечение 
аксионы: аксионы 
недолгий: недолгие 
нежели: нежели 
конвертироваться: конвертироваться 
взгляд: взгляд 
итак: Итак 
административный: административной 
мистификация: мистификации 
атавизм: атавизм 
бунин: Бунин Бунина 
лопнуть: лопнул 
функционирование: функционирования 
хак: хак 
полезно: полезно 
захардкоженный: захардкоженный 
устраивать: устраивает устраиваем 
покопаться: Покопаться 
произвольно: произвольно 
интерактивный: интерактивные интерактивных 
движок: движок 
реакция: реакция 
ретроспектива: Ретроспектива 
бережный: бережный 
обмениваться: обмениваться обменивающиеся 
заставлять: Заставлять 
кружочек: кружочках 
оценка: оценку оценкой 
антикварк: антикварка антикварков 
малодокументированной: малодокументированной 
побитный: побитному 
проказник: проказника 
коллега: коллегу коллегах 
окончательный: окончательной 
обоснованность: обоснованность 
предраковые: предраковые 
рандома: рандома 
реабилитация: реабилитации 
автомобиль: автомобилей 
товар: товаров 
обрабатываться: обрабатываются обрабатывается 
тракт: тракта 
неформальный: неформальной 
афина: Афина 
питать: питающих 
восстановить: восстановить 
взаимный: Взаимное 
превращаться: превращается 
разрядный: разрядные 
страничка: странички 
снэпшоты: снэпшоты 
итмо: ИТМО 
коуч: коуч 
дополнять: дополняет 
декомпозиция: декомпозиции 
планирование: Планирование 
пояснять: поясняющая 
полноценно: полноценно 
просуществовать: просуществует 
выделить: выделены выделенные 
проектироваться: проектируются 
дописать: дописанное 
инициативность: инициативности 
кочкин: Кочкин 
деловой: деловых 
рубеж: рубежом 
бактериальный: бактериального 
неотъемлемый: неотъемлемой 
исправно: исправно 
превосходство: превосходство 
действительность: действительности 
свобода: свобода 
выравнивание: выравниваний 
переучивать: переучивать 
убрать: убрать 
сингулярность: сингулярность сингулярности 
предотвратить: предотвратить 
относительность: относительность 
внедряться: внедряется внедряются 
длительный: длительных 
сконфигурировать: сконфигурирует 
спортсмен: спортсмена 
синхронизировать: синхронизировать 
бумажка: Бумажку 
йотбери: Йотбери 
ключевой: ключевые ключевых 
карачки: карачках 
допустить: Допустим 
перечислимый: перечислим 
салуев: Салуев 
оценить: оценить 
пожалуй: пожалуй 
самоделка: самоделки 
священный: священное 
заморочиться: заморочиться 
объединительный: объединительной 
молодой: молоды 
корень: корень корня 
делаться: делалась делается 
некоммерческий: некоммерческая 
подвергаться: подвергались подвергается 
слюноотделение: слюноотделения слюноотделение 
активность: Активность активность 
понижение: понижения 
диалоговый: диалоговых 
зарегистрироваться: зарегистрироваться 
уничтожить: уничтожите 
офис: офисы офисе 
безумный: безумных 
стрела: стрелы 
предыстория: Предыстория 
обкатать: обкатать 
форматаможно: форматаможно 
среднеуровневый: среднеуровневый 
исходник: исходников исходники 
учеток: учеток 
киберполигона: Киберполигона 
хабражители: хабражители 
красавец: красавец 
крепость: крепостях крепости 
интегрироваться: интегрируются 
строчка: строчки 
выдвинуть: выдвинуто 
разбежаться: разбегутся 
масштаб: масштабах 
опытхочу: опытХочу 
муцин: муцины 
осознавать: осознают 
суждено: суждено 
чугунов: Чугунова 
упасть: упали 
замедлять: Замедляя 
осуществляться: осуществляться осуществляется 
подтягиваться: подтягиваются 
задумать: задумано 
незаконный: незаконное 
противопоказание: противопоказания 
пауза: паузами паузы пауз 
сквозь: сквозь 
копировать: копировал 
облегчать: облегчает облегчающего 
разредить: разреженный 
медленно: медленно 
интерактивность: интерактивности 
переводиться: переводится 
истец: истца 
кадровый: кадрового 
полка: полках 
тэгов: тэгов 
пингвинята: пингвинята 
рецессия: Рецессия 
подгрузятся: подгрузятся 
воровать: ворует 
амелькин: Амелькина 
вознаграждение: вознаграждение 
фрагмент: Фрагмент 
посещать: посещает посещать 
вдыхание: вдыхание 
линия: линии линия 
увлечение: Увлечения 
кровоточивость: кровоточивость кровоточивости 
соревноваться: соревнуясь 
выделяться: выделяется 
болталка: болталка 
градус: градусов 
изучить: изучить 
выкроить: выкроить 
таймер: таймеру 
вкус: вкус 
интеллект: интеллект интеллекта 
таинственно: таинственно 
отзеркаливает: отзеркаливает 
постулат: постулата 
ночной: ночные 
выстроить: выстроенные 
урок: уроков 
вокруг: вокруг 
сейчас: Сейчас сейчас 
моддингу: моддингу 
инструментальный: инструментальное 
кириллица: кириллицы 
отобразиться: отобразится 
озвучивать: озвучиваете 
десктопных: десктопных 
макроопределение: макроопределение 
антивирусовперейдем: антивирусовПерейдем 
босс: боссы босс 
посильный: посильной 
безопасники: безопасники 
пандемия: пандемии 
линейный: линейный 
геномика: геномика 
уверенный: уверенными 
фриланс: фриланс 
спинка: спинке 
японский: японских 
угощаться: угощались 
спец: спец 
журнал: журналы 
стрелять: стрелять 
интересыфронтенд: интересыФронтенд 
подстанция: подстанции 
дискуссия: дискуссии 
интересно: Интересно интересно 
предлагать: предлагаем предлагают предлагаемая 
туксы: Туксы 
минерализация: минерализация 
отредактировать: отредактируем 
цоды: ЦОДы 
прочтение: прочтение 
таить: таит 
подытожить: подытожить 
странно: странно 
нло: НЛО 
богатый: богатый 
звонок: звонки 
жизнедеятельность: жизнедеятельности 
отсюда: Отсюда 
десктоп: десктопа 
истончать: истончать 
впервые: впервые 
необходимо: необходимо 
корея: Корее 
эффективно: эффективно 
кодаинструмент: кодаИнструмент 
страшно: страшно 
эпигеномной: эпигеномной 
влиться: влиться 
одонтобласт: одонтобластов 
повториться: повторюсь Повторюсь 
нажимать: нажимаем 
приложениязапретить: приложенияЗапретить 
да: да Да 
импортный: импортные 
цельсий: Цельсия 
мимо: мимо 
наращивать: наращиваем 
ос: ОС 
приостановить: приостановить 
интерфейсный: интерфейсных 
аэропорт: аэропортах 
итогиитак: ИтогиИтак 
скомпилируется: скомпилируется 
выспаться: выспался 
прогрессивный: прогрессивные 
синхронизироваться: синхронизируются 
наиболее: наиболее Наиболее 
отображать: отображает 
мерских: мерских 
консьюмеров: консьюмеров 
беатрис: Беатрис 
проведение: проведения 
избавиться: избавиться 
стажировка: стажировки стажировку 
мотивация: мотивацию мотивации 
восприятие: восприятие восприятия 
хрупкий: Хрупкая 
инструментарий: инструментария инструментарий 
слишком: слишком 
фирма: фирм 
действительно: действительно 
произвести: произведено 
дефрагментировать: дефрагментировать 
глотка: глотка 
кабинет: кабинет кабинета 
перевести: перевести 
быстро: быстро 
корневой: корневая 
константин: Константин 
специфика: Специфика 
геораспределенными: геораспределенными 
железка: железка 
больничный: больничные 
джунамине: джунамиНе 
смыкание: смыкания 
неожиданный: Неожиданная 
простота: простоте Простота 
устранить: Устранить 
интенсифицироваться: интенсифицируется 
гитхабе: Гитхабе 
треть: трети 
леруа: Леруа 
изящно: изящно 
документацииот: документацииОт 
андроид: андроиде 
вытаскивать: вытаскивать 
гигант: гигантов 
диагностика: диагностике диагностики диагностика 
повреждать: повреждают 
кафе: кафе 
июль: июля 
косюмере: косюмере 
патология: патологии 
питер: Питер 
рис: Рис 
прогрессировать: прогрессирующий 
комнатный: комнатной 
окончить: окончит 
отмечать: отмечают 
почерпнуть: почерпнул 
интересность: интересность 
блокировка: блокировкой блокировки 
привязка: привязку 
сильно: сильно 
великобритания: Великобритании 
дипфейков: дипфейков 
промежуток: промежутка 
телеграм: телеграм 
всё: Все все 
конвертер: конвертер 
общеизвестный: общеизвестные 
перетаскивать: перетаскивая 
гингивиту: гингивиту 
кодеглавный: кодеГлавный 
прибавлять: Прибавляем 
учить: Учу 
поднимать: Поднимаем поднимали 
детский: детских 
заклеить: заклеенным 
ловкость: ловкость 
видный: Видны 
вероятный: Вероятнее 
открытие: открытия Открытие 
покинуть: покинуть 
вращение: вращения 
естественно: Естественно естественно 
чтоб: чтоб 
персонал: персоналом 
горло: горло 
разработкев: разработкеВ 
ссылкичуть: ссылкиЧуть 
курильщикакариесотбеливание: курильщикакариесотбеливание 
детально: Детально 
лаконичность: лаконичность 
антиводород: антиводород 
мелкий: мелких 
ортонормированный: ортонормированных 
предназначаться: предназначается 
крик: крики 
придание: придании 
тонкость: тонкости 
легаси: Легаси 
храм: храме 
снова: снова 
высокооплачиваемый: высокооплачиваемых 
профессионально: профессионально 
ах: ах 
инфраструктураразработка: инфраструктураразработка 
лазерный: лазерной 
палец: пальца 
матрикс: матрикс 
гарантия: гарантия 
вольный: вольно 
выходить: выходят 
пк: ПК 
размещение: размещения 
фармакологический: фармакологических 
запереть: запереть 
отличаться: отличается отличаются 
инициализация: инициализация инициализации 
гамма: гамма 
интересовать: интересует 
синтаксический: синтаксический синтаксическими 
предубеждение: предубеждения 
рептилоид: Рептилоид 
стокгольмский: Стокгольмского 
целочисленный: целочисленные 
обращаться: обращается обращайтесь 
адвокат: адвокат 
повлечь: повлечет 
коммитов: коммитов 
мирный: мирных 
трансформироваться: трансформироваться 
приложить: приложив 
щёлкать: щелкаем 
антиатом: антиатомы 
уксусный: уксусная 
эвристический: эвристический 
графический: графические графических 
борьба: борьбы 
счистить: счистить 
диммеров: диммеров 
дверной: дверных 
сша: США 
подстройка: подстройка 
лунка: лунке 
исходно: Исходно 
разделить: разделены 
врач: врачах 
жизненный: Жизненный жизненный 
слегка: слегка 
максим: Максим 
оформить: оформить оформлен 
понадобиться: понадобиться понадобилось понадобится 
отпечаток: отпечатку 
хамамы: хамамы 
отступ: отступ 
массив: массиве массив 
машиночитаемый: машиночитаемые 
призма: призму 
вуаля: Вуаля 
хакер: хакеров 
обработчик: обработчик 
качественно: качественно 
канальцы: канальцы 
услышать: услышать 
нибудь: нибудь 
закрывать: закрывал 
захардкоженных: захардкоженных 
ожидание: ожидания 
экономикиразработка: ЭкономикиРазработка 
докер: докер 
накладывать: накладывать 
поместить: поместили 
уход: ухода уходом уход 
заменяться: заменяется 
райффайзен: Райффайзен 
подборка: подборки подборка 
среднестатистический: среднестатистической 
винокуров: Винокуров 
ветеран: ветеранов 
череп: черепа 
недорогой: недороги 
вдоль: вдоль 
минимизировать: минимизировать 
формула: формуле 
бурцев: Бурцева 
подлежать: подлежат 
гвс: ГВС 
произойти: произошло 
эталонный: эталонная 
забавный: забавного 
ненормальный: Ненормальное 
доктор: доктор 
перечислить: перечислить 
книга: книги книгу книг 
капитализм: капитализма 
резерфорд: Резерфорд 
оттуда: Оттуда оттуда 
тред: тредами треды 
отщепенец: отщепенца 
потерпеть: потерпеть 
высокоабразивной: высокоабразивной 
перезапустить: Перезапустим 
веб: веб Веб 
измерять: измерять 
консьюмерские: консьюмерские 
резонатор: резонатор резонатором 
целиком: целиком 
одноплатников: одноплатников 
подозрение: подозрениями 
приёмка: Приемка 
кроватка: кроваток 
блогер: блогеров 
механически: механически 
установленный: установленные установленными установленный 
защищённость: защищенность защищенности 
берет: берете 
ассортимент: ассортименте 
подарить: подарило 
финансировать: финансируемый 
объяснять: объясняем объясняет 
товарищ: товарищей 
голый: голым 
секция: секцию 
произнести: произнести 
фрилансе: Фрилансе 
прошивка: прошивка 
новенький: новенький 
радио: радио 
ясно: ясно 
цемент: цемент 
перемещаться: перемещаются 
выписка: выписке 
идентификациинаш: идентификацииНаш 
аннигиляция: аннигиляция 
брат: брата брату 
согласовать: согласованных 
зарядить: заряжены 
род: рода 
макродвижок: макродвижок 
модальность: модальности 
коднадо: КодНадо 
рост: рост роста 
заполнять: заполнять 
позитроний: позитроний 
заводский: заводским 
постольку: постольку 
диммера: диммера 
компонентный: компонентный 
раздражать: раздражают 
подключить: подключат 
украшать: украшает 
шим: ШИМ 
надстройкиразработанная: надстройкиРазработанная 
трилогия: трилогия 
мана: маны 
иерархия: иерархию 
чередовать: чередовать 
масштабируемость: масштабируемости 
ривера: Ривера 
памятиполитика: памятиполитика 
ландшафт: ландшафт 
стартапер: стартаперов 
демонстрация: демонстрацию 
дизайнер: дизайнер 
потребительский: потребительские 
параграф: параграфов 
запить: запить 
оплошность: оплошности 
накладка: накладки 
стоматологический: стоматологической 
гиперчувствительность: гиперчувствительность 
уязвимостив: уязвимостиВ 
алексей: Алексей 
раздача: раздача 
атмосфера: атмосферой атмосферу 
завтра: завтра 
стремление: стремление 
старожил: Старожил 
апплет: апплеты 
врождённый: врожденно 
согласоваться: согласуются 
сброс: сброс 
городской: городской 
устранение: устранение 
физический: физической физическое 
лейкин: Лейкин 
сложно: сложно 
очень: очень 
легенда: Легенда 
устойчивый: устойчивые 
законодательный: законодательных 
приоритетный: приоритетная 
пакетик: пакетик 
редакция: редакции редакциям 
покрывать: покрывать 
справляться: справляется 
коронавирус: коронавируса 
сисадмин: сисадминов 
подтип: подтипы 
водитель: водителя водитель 
мероприятие: мероприятия 
выравнивать: выравнивать 
успешно: успешно 
простить: Простите 
путём: путем 
воспалительный: воспалительный воспалительных 
помалу: помалу 
относить: относят 
остаток: остатков 
всепланетный: Всепланетная 
специализированный: специализированных 
ознакомиться: ознакомиться 
предполагаться: предполагается 
мошенничество: мошенничестве 
линковщик: линковщик 
тёмный: Темные 
носитель: носителями 
синергетический: синергетического 
широко: широко 
лем: Лем 
программно: программно 
нацелить: нацеленном 
прямиком: прямиком 
инфраструктурасистемное: инфраструктураСистемное 
вводить: вводим вводимых 
самонаводящийся: самонаводящихся 
сигнатурный: сигнатурному 
союз: Союза 
подвести: подвести 
сочетаться: сочетается 
разрабатываться: Разрабатывается разрабатываются 
назначать: назначаем 
вечер: вечерам 
случайный: случайных 
ломать: ломает 
усугубляться: усугубляется 
дистрибутив: дистрибутив 
южный: Южной 
свободно: свободно 
юнус: Юнусов 
металл: металлов 
посредством: посредством 
константа: константами 
сбалансированный: сбалансированной 
проникнуть: проникнуть 
оптимизация: оптимизации 
централизованный: централизованной 
узнавать: узнают 
однотипный: однотипным 
уменьшать: уменьшает 
соединение: соединения 
светлый: светлее 
предок: Предки 
интерпретируемость: интерпретируемость 
терпеть: терпел 
калифорнийский: Калифорнийского 
перезапуск: перезапуске 
кератин: кератина 
вконтакте: ВКонтакте 
больно: больно 
кластеризация: кластеризацию 
свежесделанное: свежесделанное 
салют: Салют 
саморазвитие: Саморазвитие 
ошпарить: ошпарит 
годный: годного 
полифенолов: полифенолов 
ныне: ныне 
оккупировать: оккупированной 
записываться: записываются 
обеспечить: обеспечит обеспечить 
вместо: вместо 
надстройкине: надстройкине 
контекст: контексте контекст 
английский: Английский 
родственник: родственников 
пофиксил: пофиксил 
петербург: Петербург 
блокировщиком: блокировщиком 
видеоинструкции: видеоинструкции 
гипотеза: Гипотезе гипотез 
хабе: хабе 
десктопные: десктопные 
людмила: Людмила 
британский: британский 
совместимость: совместимостью совместимость 
вкратце: вкратце 
валерий: Валерий 
бухаловматематик: БухаловМатематик 
долгопрудненский: Долгопрудненское 
спам: спама 
получатель: получателя 
патологический: патологические патологической 
нумерация: нумерация 
вычислитель: вычислитель 
доступасистема: доступасистема 
осветлять: осветляющие 
убедить: убедить 
николай: Николай 
десневую: десневую 
беготня: беготни 
запрет: Запрет 
оголять: оголяя 
интеллектуально: интеллектуально 
наркоз: наркоз 
мерче: мерче 
глотать: глотать 
альцгеймера: Альцгеймера 
традиционный: Традиционный 
менеджер: менеджерам 
выдаваться: выдаются 
продовских: продовских 
водоворот: водовороте 
увеличивать: увеличивает 
аналогично: Аналогично аналогично 
подряд: подряд 
след: следы 
неподготовленный: неподготовленным 
устраиваться: устраивались 
файлдва: файлдва 
выраженный: выраженного 
соответствующий: соответствующих соответствующего соответствующими 
мода: мода моде мод 
внимательно: внимательно 
популярноефизика: популярноеФизика 
бег: бег 
приём: приемы 
несовершеннолетний: несовершеннолетних 
жц: ЖЦ 
методический: методической 
манипулировать: манипулировать 
норвежский: норвежские 
рад: рад 
стилистический: стилистических 
окирпичивания: окирпичивания 
травма: травмам 
нафаршировать: нафаршированы 
популяция: популяции 
шаблонный: шаблонного 
доп: доп 
термоголовки: термоголовки 
отделять: отделять 
клинический: клинических 
тело: тела 
дублировать: дублируем 
планшет: планшеты 
установочный: установочных установочный 
разнообразие: разнообразие 
научить: научил 
забрать: забрала 
внизу: внизу 
сентябрь: сентября 
московский: Московская 
дао: Дао 
организовать: организованы организовать 
опускать: опускаю 
промышленный: промышленном 
листинг: листингами 
пневмония: пневмонии 
рефакторинг: рефакторинга 
пытка: пыткой 
метапластические: метапластические 
ультразвук: ультразвук 
спать: спят 
сопроводительный: сопроводительной 
утомлять: утомлять 
зашифровать: зашифрованные 
битрикс: Битрикс 
параметрический: параметрический 
шифровальщик: шифровальщиков 
компрометация: компрометацией 
округ: округа 
охранный: охранные 
бюджетности: бюджетности 
седацию: седацию 
превентивный: Превентивные 
синий: синяя Синяя 
противоположность: противоположность 
исключительно: исключительно 
свежесозданный: свежесозданный 
служить: служило служит 
расшатываться: расшатываются 
между: между 
структурировать: структурированные 
изредка: изредка 
приятель: приятелей 
почитать: почитать 
молодец: молодец 
конфликт: конфликт конфликтов 
визуально: визуально 
вентилятор: вентиляторы 
отличие: отличие 
мало: мало 
схемотехнику: схемотехнику 
сосочка: сосочкам 
евгений: Евгения 
утилит: утилитами 
парогенератор: парогенератором 
реминерализующие: реминерализующие 
русификация: русификацию 
телеключ: Телеключ 
маркер: маркерами 
прошивокевгений: прошивокЕвгений 
рубль: рублей 
копание: копанию 
лекция: лекции 
сжиматься: сжимаются 
рассчитать: рассчитана 
умереть: умереть 
фанеро: Фанеро 
повод: повод 
пауль: Паули 
мусоратеперь: мусораТеперь 
тяжело: тяжело 
модовский: модовский 
трудность: трудностями трудность 
энергетика: энергетике 
желание: желание 
растить: Растим 
устройствадоклад: устройстваДоклад 
внести: внести 
желтеть: желтеют 
документациипланирование: документацииПланирование 
исполняемый: исполняемого 
атомный: атомной 
изначально: Изначально 
трофика: трофику 
газпромбанк: Газпромбанк 
смерть: смерти 
совершенствовать: совершенствовать 
джой: Джой 
распознать: распознана 
послужить: послужил 
станиоль: станиоль 
многопрофильный: многопрофильная 
зубодесневой: зубодесневого 
развитой: развитые 
нормаль: нормали 
вплотную: вплотную 
ноябрь: ноября 
компромисс: компромиссов 
согласовываться: согласовываться 
соблюдать: соблюдают 
давний: давние 
анкета: анкету 
нетерпеливый: нетерпеливый 
джунаищем: джунаИщем 
цилиндрический: цилиндрической 
предсказание: предсказание 
наслать: нашли 
упроститься: упростится 
разрешать: Разрешать 
павел: Павел 
изложение: изложения 
модификация: модификаций 
легко: легко 
подсказка: подсказки подсказок 
кризис: кризиса 
антипротонном: антипротонном 
шестаков: Шестакова 
приоритет: приоритета 
жертва: жертвы 
триллион: триллионов 
моддинг: моддинг 
частность: частности 
обсудить: обсудите 
богдан: Богдан 
тестирование: тестирования 
подложка: подложек 
поступить: поступить 
можно: можно Можно 
трансформировать: Трансформируем 
тестировщикам: тестировщикам 
подводить: Подводя 
наподобие: наподобие 
ороговевающий: ороговевающий 
выжать: выжать 
производиться: производилось 
взлом: взлома 
готовность: готовность 
скидывать: скидывайте 
поставлять: поставляет 
предельно: Предельно 
рано: рано 
влезть: влезут 
долгосрочный: долгосрочной 
незакрытый: незакрытых 
именовать: именуемым 
пробовать: пробовал 
эмулятор: эмулятор 
воздержаться: воздержаться 
десневой: десневой 
нарушаться: нарушается 
петабайтов: петабайтов 
киберполигонах: киберполигонах 
тривиальный: тривиальные 
грязь: грязь 
заключений: ЗаключениеВ 
нейтронный: нейтронные 
чердак: чердака 
подаваться: подаваться 
игнорироваться: игнорируются 
суть: сути 
убирать: убирает убирать 
железячные: Железячные 
реанимационный: реанимационных 
спираль: спирали 
оперативно: оперативно 
транзакция: транзакций 
бассейн: бассейн 
нанять: нанять 
издательский: Издательский 
поражение: Поражения 
довольно: довольно 
выкурить: выкуренной 
ом: ом 
астроном: астронома 
фев: фев 
джет: Джет 
перепробовать: перепробовал 
баффы: баффы 
эйнштейн: Эйнштейна 
иммунитет: иммунитета 
рисоваться: рисуется 
непостоянный: непостоянные 
специальность: специальностям 
грудной: грудной 
коротко: Коротко 
предшественник: предшественника 
лендингах: лендингах 
оффов: оффов 
озадачиться: озадачился 
улучшить: улучшена 
анонсировать: анонсирована 
страховой: страховых 
кодинга: Кодинга 
седьмой: седьмом 
чётко: четко 
статика: статики 
алфавит: алфавита 
разрез: разрезе 
тесный: тесном 
беспокоиться: беспокоиться 
отстранять: отстранять 
метка: меток 
выучить: Выучив 
обидно: Обидно 
многослойный: многослойного 
переусердствовать: переусердствовать 
иб: ИБ 
дитя: дитя 
немой: нем 
надолго: надолго 
заказывать: заказывать 
переносить: переносить 
предлагаться: предлагаются 
пигментный: пигментные 
сериальный: Сериальный 
вселенная: Вселенной 
инвестиция: инвестиция 
доставка: доставки 
вашингтонский: Вашингтонском 
задаваться: задается 
заполняться: заполняется 
приблизить: приблизить 
нечёткий: нечеткое 
броня: броню 
познание: познания 
индия: Индии 
стабильность: стабильность 
отобразить: отобразить 
размещать: размещая 
греть: греете 
чей: чей 
бодро: бодро 
распределённый: распределенная 
репутационный: репутационные 
издание: издания 
сознательность: сознательности 
заесть: заесть 
смс: СМС 
продажа: продаже 
крайне: крайне 
девайс: девайса 
давление: давление 
гидроксиапатитов: гидроксиапатитов 
ес: ЕС 
выживаемость: выживаемости 
тематика: тематикой 
фантазия: фантазией 
наноситься: наносятся 
опытный: опытного 
полгода: полгода 
радиоактивный: радиоактивном 
наследство: наследству 
тыс: тыс 
несбалансированный: несбалансированные 
обширный: обширный 
отсутствовать: отсутствует 
печально: Печально 
энергоменеджмент: энергоменеджмент 
развернуть: развернуть 
договор: договоров 
комиссаров: Комиссарова 
вдохнуть: вдохнули 
накапливать: накапливают 
ланита: ЛАНИТ 
сей: сих 
гитара: гитара 
представление: представление 
держать: Держите 
вычищать: вычищать 
сердце: сердце 
интерпретация: интерпретацией 
маркировать: маркировать 
латинский: латинская 
куцев: Куцев 
ру: ру 
домантон: домАнтон 
задумываться: задумываются 
коричневый: коричневый 
хардкодь: хардкодь 
активировать: активируем 
мессенджер: Мессенджере 
упоминаться: упоминавшиеся 
фраза: фразы 
пзу: ПЗУ 
рядовой: рядовые 
пр: пр 
тянуть: тянет 
встраиваться: встраиваются 
выталкивать: выталкивать 
стремительно: стремительно 
коммуницировать: Коммуницировать 
компенсировать: компенсированная 
оптимальный: оптимальную 
никогда: никогда 
аудиовизуальный: аудиовизуальное 
пересборке: пересборке 
вентиляция: вентиляцией 
учесть: учесть 
тэги: тэги 
параллельно: параллельно 
методичка: методички 
кубический: кубических 
онбординга: онбординга 
